Year,CountryOrigin,CountryOriginISO,CountryAsylum,CountryAsylumISO,Female0-4,Female5-11,Female12-17,Female18-59,Female60,FemaleOther,FemaleTotal,Male0-4,Male0-4,Male5-11,Male12-17,Male18-59,Male60,MaleOther,Total
2022,Venezuela (Bolivarian Republic of),VEN,Aruba,ABW,0,0,0,0,0,9000,9000,0,0,0,0,0,8000,8000,17000
2022,Bangladesh,BGD,Afghanistan,AFG,0,5,0,0,0,0,5,0,0,0,0,0,0,0,5
2022,Iran (Islamic Rep. of),IRN,Afghanistan,AFG,0,13,9,12,0,0,34,0,12,0,10,0,0,22,56
2022,Pakistan,PAK,Afghanistan,AFG,5477,6071,3564,11477,1161,0,27750,4931,6218,3175,8751,1485,0,24560,52310
2022,Tajikistan,TJK,Afghanistan,AFG,0,0,0,0,0,0,0,0,0,0,6,0,0,6,6
2022,Afghanistan,AFG,Albania,ALB,0,0,0,7,0,0,7,0,7,0,0,0,0,7,14
2022,Egypt,EGY,Albania,ALB,0,8,0,0,0,0,8,0,0,0,0,0,0,0,8
2022,China,CHN,Albania,ALB,0,5,0,0,0,0,5,0,9,0,0,0,0,9,14
2022,Palestinian,PSE,Albania,ALB,0,0,8,0,0,0,8,0,0,0,0,0,0,0,8
2022,Serbia and Kosovo: S/RES/1244 (1999),SRB,Albania,ALB,0,5,5,6,5,0,21,5,0,5,16,5,0,31,52
2022,Syrian Arab Rep.,SYR,Albania,ALB,0,0,5,5,0,0,10,0,0,5,8,0,0,13,23
2022,Tunisia,TUN,Albania,ALB,0,5,0,0,0,0,5,0,0,0,0,0,0,0,5
2022,Ukraine,UKR,Albania,ALB,0,0,0,0,0,0,0,5,0,0,0,0,0,5,2547
2022,Uzbekistan,UZB,Albania,ALB,0,0,0,0,0,0,0,0,5,0,0,0,0,5,5
2022,Venezuela (Bolivarian Republic of),VEN,Albania,ALB,0,0,5,0,0,0,5,0,0,0,0,0,0,0,5
2022,Egypt,EGY,Algeria,DZA,0,0,0,0,0,0,0,0,0,0,5,0,0,5,5
2022,Benin,BEN,Algeria,DZA,12,5,5,23,0,0,45,9,0,7,75,0,0,91,136
2022,Burkina Faso,BFA,Algeria,DZA,5,7,0,8,0,0,20,0,0,15,82,0,0,97,117
2022,Central African Rep.,CAF,Algeria,DZA,5,0,0,24,0,0,29,9,0,26,133,0,0,168,197
2022,Chad,TCD,Algeria,DZA,0,0,0,5,0,0,5,0,0,9,33,0,0,42,47
2022,Cameroon,CMR,Algeria,DZA,53,27,21,284,0,0,385,61,26,35,221,0,0,343,728
2022,Congo,COG,Algeria,DZA,0,0,5,0,0,0,5,0,0,0,5,0,0,5,10
2022,Dem. Rep. of the Congo,COD,Algeria,DZA,12,15,15,63,0,0,105,16,16,10,56,0,0,98,203
2022,Eritrea,ERI,Algeria,DZA,0,0,0,0,0,0,0,0,0,5,5,0,0,10,10
2022,Ethiopia,ETH,Algeria,DZA,0,0,0,0,0,0,0,0,0,0,5,0,0,5,5
2022,Gambia,GMB,Algeria,DZA,0,0,5,0,0,0,5,0,0,0,0,0,0,0,5
2022,Palestinian,PSE,Algeria,DZA,5,12,13,52,7,0,89,11,17,12,106,8,0,154,243
2022,Ghana,GHA,Algeria,DZA,0,0,0,5,0,0,5,0,0,0,8,0,0,8,13
2022,Guinea-Bissau,GNB,Algeria,DZA,0,0,0,0,0,0,0,0,0,0,6,0,0,6,6
2022,Guinea,GIN,Algeria,DZA,48,10,29,133,0,0,220,53,7,46,337,0,0,443,663
2022,Cote d'Ivoire,CIV,Algeria,DZA,20,5,25,94,0,0,144,11,5,19,147,0,0,182,326
2022,India,IND,Algeria,DZA,5,0,0,0,0,0,5,0,0,0,0,0,0,0,5
2022,Iraq,IRQ,Algeria,DZA,0,6,0,0,0,0,6,0,0,0,10,5,0,15,21
2022,Jordan,JOR,Algeria,DZA,0,0,0,5,0,0,5,0,0,0,0,0,0,0,5
2022,Liberia,LBR,Algeria,DZA,11,0,0,22,0,0,33,8,0,0,73,0,0,81,114
2022,Libya,LBY,Algeria,DZA,0,0,6,5,0,0,11,0,7,5,14,0,0,26,37
2022,Lebanon,LBN,Algeria,DZA,0,0,0,9,0,0,9,0,0,0,0,0,0,0,9
2022,Mali,MLI,Algeria,DZA,43,27,24,116,0,0,210,47,26,26,587,0,0,686,896
2022,Niger,NER,Algeria,DZA,8,5,0,11,0,0,24,0,14,0,167,0,0,181,205
2022,Nigeria,NGA,Algeria,DZA,28,23,15,141,0,0,207,33,17,10,182,0,0,242,449
2022,Senegal,SEN,Algeria,DZA,0,0,0,0,0,0,0,0,0,0,9,0,0,9,9
2022,Sierra Leone,SLE,Algeria,DZA,5,0,0,9,0,0,14,0,0,6,34,0,0,40,54
2022,Sudan,SDN,Algeria,DZA,0,0,0,10,0,0,10,0,0,15,88,0,0,103,113
2022,Syrian Arab Rep.,SYR,Algeria,DZA,350,727,390,1508,70,0,3045,413,807,456,3001,81,0,4758,7803
2022,Togo,TGO,Algeria,DZA,0,0,0,0,0,0,0,0,0,0,19,0,0,19,19
2022,Türkiye,TUR,Algeria,DZA,0,0,0,0,0,0,0,0,0,0,7,0,0,7,7
2022,Western Sahara,ESH,Algeria,DZA,0,0,0,0,0,0,0,0,0,0,0,0,0,0,90000
2022,Yemen,YEM,Algeria,DZA,5,7,7,37,5,0,61,0,13,9,205,5,0,232,293
2022,Burundi,BDI,Angola,AGO,0,0,0,0,0,0,0,0,0,0,0,0,0,0,114
2022,Central African Rep.,CAF,Angola,AGO,0,0,0,0,0,0,0,0,0,0,0,0,0,0,84
2022,Chad,TCD,Angola,AGO,0,0,0,0,0,0,0,0,0,0,0,0,0,0,968
2022,Congo,COG,Angola,AGO,0,0,0,0,0,0,0,0,0,0,0,0,0,0,123
2022,Dem. Rep. of the Congo,COD,Angola,AGO,719,1181,725,1991,103,0,4719,737,1186,668,1782,166,0,4539,23141
2022,Eritrea,ERI,Angola,AGO,0,0,0,0,0,0,0,0,0,0,0,0,0,0,1874
2022,Ethiopia,ETH,Angola,AGO,0,0,0,0,0,0,0,0,0,0,0,0,0,0,57
2022,Guinea-Bissau,GNB,Angola,AGO,0,0,0,0,0,0,0,0,0,0,0,0,0,0,275
2022,Guinea,GIN,Angola,AGO,0,0,0,0,0,0,0,0,0,0,0,0,0,0,9272
2022,Cote d'Ivoire,CIV,Angola,AGO,0,0,0,0,0,0,0,0,0,0,0,0,0,0,6357
2022,Liberia,LBR,Angola,AGO,0,0,0,0,0,0,0,0,0,0,0,0,0,0,639
2022,Mauritania,MRT,Angola,AGO,0,0,0,0,0,0,0,0,0,0,0,0,0,0,5725
2022,Rwanda,RWA,Angola,AGO,0,0,0,0,0,0,0,0,0,0,0,0,0,0,633
2022,Sierra Leone,SLE,Angola,AGO,0,0,0,0,0,0,0,0,0,0,0,0,0,0,1909
2022,Somalia,SOM,Angola,AGO,0,0,0,0,0,0,0,0,0,0,0,0,0,0,2002
2022,Sudan,SDN,Angola,AGO,0,0,0,0,0,0,0,0,0,0,0,0,0,0,1949
2022,Syrian Arab Rep.,SYR,Angola,AGO,0,0,0,0,0,0,0,0,0,0,0,0,0,0,5
2022,United Rep. of Tanzania,TZA,Angola,AGO,0,0,0,0,0,0,0,0,0,0,0,0,0,0,5
2022,Türkiye,TUR,Angola,AGO,0,0,0,0,0,0,0,0,0,0,0,0,0,0,32
2022,Uganda,UGA,Angola,AGO,0,0,0,0,0,0,0,0,0,0,0,0,0,0,6
2022,Western Sahara,ESH,Angola,AGO,0,0,0,0,0,0,0,0,0,0,0,0,0,0,612
2022,Afghanistan,AFG,Egypt,EGY,15,32,0,52,0,0,99,10,17,5,250,0,0,282,381
2022,Burundi,BDI,Egypt,EGY,0,5,0,54,0,0,59,0,0,5,60,0,0,65,124
2022,Bangladesh,BGD,Egypt,EGY,5,0,0,0,0,0,5,0,0,0,0,0,0,0,5
2022,Central African Rep.,CAF,Egypt,EGY,0,0,0,5,0,0,5,0,0,5,68,0,0,73,78
2022,Chad,TCD,Egypt,EGY,0,10,21,16,0,0,47,0,0,28,44,0,0,72,119
2022,China,CHN,Egypt,EGY,6,9,0,16,0,0,31,5,6,7,28,0,0,46,77
2022,Cameroon,CMR,Egypt,EGY,0,0,0,19,0,0,19,5,0,5,25,0,0,35,54
2022,Congo,COG,Egypt,EGY,0,0,0,6,0,0,6,0,0,0,25,0,0,25,31
2022,Dem. Rep. of the Congo,COD,Egypt,EGY,5,0,8,14,0,0,27,0,5,0,32,0,0,37,64
2022,Djibouti,DJI,Egypt,EGY,0,6,0,0,0,0,6,0,0,8,33,0,0,41,47
2022,Eritrea,ERI,Egypt,EGY,702,1401,1861,7202,340,0,11506,816,1650,2037,6155,243,0,10901,22407
2022,Ethiopia,ETH,Egypt,EGY,921,353,278,7877,13,0,9442,916,375,203,4868,20,0,6382,15824
2022,Palestinian,PSE,Egypt,EGY,0,0,0,5,0,35001,35006,0,0,8,5,0,35001,35014,70020
2022,Guinea,GIN,Egypt,EGY,5,0,0,21,0,0,26,5,0,0,35,0,0,40,66
2022,Cote d'Ivoire,CIV,Egypt,EGY,0,0,0,0,0,0,0,0,0,0,5,0,0,5,5
2022,India,IND,Egypt,EGY,0,0,5,0,0,0,5,0,0,0,0,0,0,0,5
2022,Iraq,IRQ,Egypt,EGY,43,249,351,1823,331,0,2797,39,235,359,1878,367,0,2878,5675
2022,Jordan,JOR,Egypt,EGY,0,0,0,0,0,0,0,0,0,0,18,0,0,18,18
2022,Kenya,KEN,Egypt,EGY,7,0,0,6,0,0,13,0,5,0,0,0,0,5,18
2022,Libya,LBY,Egypt,EGY,0,0,0,0,0,0,0,0,0,0,10,0,0,10,10
2022,Lebanon,LBN,Egypt,EGY,0,5,0,0,0,0,5,0,0,0,0,0,0,0,5
2022,Mali,MLI,Egypt,EGY,0,0,0,6,0,0,6,0,0,0,0,0,0,0,6
2022,Nigeria,NGA,Egypt,EGY,5,6,5,60,0,0,76,10,6,0,48,0,0,64,140
2022,Russian Federation,RUS,Egypt,EGY,0,0,5,0,0,0,5,0,0,5,9,0,0,14,19
2022,Rwanda,RWA,Egypt,EGY,0,0,0,5,0,0,5,0,0,0,0,0,0,0,5
2022,Saudi Arabia,SAU,Egypt,EGY,0,0,0,0,0,0,0,0,5,0,0,0,0,5,5
2022,Sierra Leone,SLE,Egypt,EGY,0,0,0,10,0,0,10,0,0,0,0,0,0,0,10
2022,Somalia,SOM,Egypt,EGY,240,339,384,2524,126,0,3613,263,338,421,1759,43,0,2824,6437
2022,South Sudan,SSD,Egypt,EGY,1311,2091,1789,6983,205,0,12379,1374,2255,1721,6549,68,0,11967,24346
2022,Stateless,XXA,Egypt,EGY,0,0,0,0,5,0,5,0,0,0,0,0,0,0,5
2022,Sudan,SDN,Egypt,EGY,3189,4936,4008,14843,437,0,27413,3222,5175,4870,16895,662,0,30824,58237
2022,Syrian Arab Rep.,SYR,Egypt,EGY,6153,11666,9542,37095,3933,0,68389,6557,12097,10660,44093,3862,0,77269,145658
2022,United Rep. of Tanzania,TZA,Egypt,EGY,0,0,0,0,0,0,0,0,5,0,0,0,0,5,5
2022,Tajikistan,TJK,Egypt,EGY,0,0,10,5,0,0,15,0,0,0,6,0,0,6,21
2022,Turkmenistan,TKM,Egypt,EGY,0,0,5,0,0,0,5,0,0,0,0,0,0,0,5
2022,Tunisia,TUN,Egypt,EGY,0,0,0,5,0,0,5,0,0,0,0,0,0,0,5
2022,Türkiye,TUR,Egypt,EGY,11,33,19,86,10,0,159,12,36,12,106,11,0,177,336
2022,Uganda,UGA,Egypt,EGY,0,5,0,15,0,0,20,0,0,0,5,0,0,5,25
2022,Ukraine,UKR,Egypt,EGY,0,0,0,5,0,0,5,0,0,0,0,0,0,0,5
2022,Uzbekistan,UZB,Egypt,EGY,0,8,0,0,0,0,8,0,0,0,0,0,0,0,8
2022,Yemen,YEM,Egypt,EGY,245,637,622,2648,222,0,4374,254,680,677,1984,186,0,3781,8155
2022,Zimbabwe,ZWE,Egypt,EGY,0,0,5,23,0,0,28,0,6,0,13,0,0,19,47
2022,Afghanistan,AFG,Argentina,ARG,0,6,0,5,0,0,11,0,0,6,5,0,0,11,22
2022,Albania,ALB,Argentina,ARG,0,0,0,5,5,0,10,0,0,0,8,0,0,8,18
2022,Algeria,DZA,Argentina,ARG,0,0,0,6,0,0,6,0,0,0,40,6,0,46,52
2022,Angola,AGO,Argentina,ARG,0,0,0,5,0,0,5,0,5,0,9,0,0,14,29
2022,Egypt,EGY,Argentina,ARG,0,0,0,12,0,0,12,0,0,0,10,0,0,10,27
2022,Armenia,ARM,Argentina,ARG,0,0,9,51,17,0,77,0,7,6,82,13,0,108,246
2022,Burundi,BDI,Argentina,ARG,0,0,0,0,0,0,0,0,0,0,5,0,0,5,5
2022,Bangladesh,BGD,Argentina,ARG,0,0,0,0,0,0,0,0,0,0,62,0,0,62,96
2022,Belarus,BLR,Argentina,ARG,0,5,0,9,0,0,14,0,0,0,5,0,0,5,19
2022,Bolivia (Plurinational State of),BOL,Argentina,ARG,0,0,8,33,10,0,51,0,5,5,45,11,0,66,117
2022,Brazil,BRA,Argentina,ARG,0,0,0,9,0,0,9,0,5,0,9,0,0,14,23
2022,Bosnia and Herzegovina,BIH,Argentina,ARG,0,0,0,6,0,0,6,0,0,0,0,0,0,0,6
2022,China,CHN,Argentina,ARG,0,0,0,11,0,0,11,0,0,0,33,0,0,33,121
2022,Chile,CHL,Argentina,ARG,0,0,0,24,0,0,24,0,0,0,7,10,0,17,41
2022,Cameroon,CMR,Argentina,ARG,0,0,0,0,0,0,0,0,0,0,31,0,0,31,49
2022,Dem. Rep. of the Congo,COD,Argentina,ARG,0,0,0,13,0,0,13,0,0,0,20,0,0,20,55
2022,Colombia,COL,Argentina,ARG,9,5,17,291,42,0,364,5,5,25,380,37,0,452,856
2022,Costa Rica,CRI,Argentina,ARG,0,0,0,5,0,0,5,0,0,0,0,0,0,0,5
2022,Cuba,CUB,Argentina,ARG,0,6,5,236,45,0,292,0,13,7,451,48,0,519,1091
2022,Cabo Verde,CPV,Argentina,ARG,0,0,0,0,0,0,0,0,0,0,5,0,0,5,5
2022,Czechia,CZE,Argentina,ARG,0,0,0,0,0,0,0,0,0,0,0,0,0,0,5
2022,Dominican Rep.,DOM,Argentina,ARG,0,0,5,216,0,0,221,0,0,8,156,0,0,164,510
2022,Ecuador,ECU,Argentina,ARG,9,0,5,10,0,0,24,0,8,6,11,0,0,25,49
2022,Eritrea,ERI,Argentina,ARG,0,0,0,5,0,0,5,0,0,0,7,0,0,7,12
2022,Ethiopia,ETH,Argentina,ARG,0,0,0,0,0,0,0,0,0,0,5,0,0,5,5
2022,Gambia,GMB,Argentina,ARG,0,0,0,0,0,0,0,0,0,0,0,0,0,0,5
2022,Palestinian,PSE,Argentina,ARG,0,0,0,8,0,0,8,0,0,5,21,0,0,26,34
2022,Georgia,GEO,Argentina,ARG,0,0,0,0,0,0,0,0,0,0,5,0,0,5,5
2022,Ghana,GHA,Argentina,ARG,0,0,0,23,0,0,23,0,0,0,88,0,0,88,181
2022,Guinea-Bissau,GNB,Argentina,ARG,0,0,0,8,0,0,8,0,0,0,0,0,0,0,13
2022,Guatemala,GTM,Argentina,ARG,0,0,0,8,0,0,8,0,0,0,0,0,0,0,8
2022,Guinea,GIN,Argentina,ARG,0,0,0,0,0,0,0,0,0,0,10,0,0,10,20
2022,Haiti,HTI,Argentina,ARG,0,8,6,197,5,0,216,0,7,10,215,5,0,237,688
2022,Honduras,HND,Argentina,ARG,0,0,0,5,0,0,5,0,0,0,10,0,0,10,15
2022,Hungary,HUN,Argentina,ARG,0,0,0,0,0,0,0,0,0,0,0,0,0,0,5
2022,Cote d'Ivoire,CIV,Argentina,ARG,0,0,0,0,0,0,0,0,0,0,20,0,0,20,25
2022,India,IND,Argentina,ARG,0,0,0,16,0,0,16,0,0,5,59,5,0,69,151
2022,Iran (Islamic Rep. of),IRN,Argentina,ARG,0,0,0,6,7,0,13,0,0,0,16,6,0,22,35
2022,Iraq,IRQ,Argentina,ARG,0,0,0,6,0,0,6,0,0,0,15,5,0,20,26
2022,Jamaica,JAM,Argentina,ARG,0,0,0,0,0,0,0,0,0,0,14,0,0,14,14
2022,Jordan,JOR,Argentina,ARG,0,0,0,10,0,0,10,0,0,0,0,0,0,0,10
2022,Kazakhstan,KAZ,Argentina,ARG,5,0,0,14,0,0,19,0,0,0,18,0,0,18,42
2022,Kyrgyzstan,KGZ,Argentina,ARG,0,0,0,0,0,0,0,0,0,0,5,0,0,5,5
2022,Liberia,LBR,Argentina,ARG,0,0,0,0,0,0,0,0,0,0,31,11,0,42,42
2022,Libya,LBY,Argentina,ARG,0,0,0,0,0,0,0,0,5,0,5,0,0,10,10
2022,Sri Lanka,LKA,Argentina,ARG,0,0,0,6,0,0,6,0,0,0,18,12,0,30,36
2022,North Macedonia,MKD,Argentina,ARG,0,0,0,0,0,0,0,0,0,0,9,0,0,9,9
2022,Mexico,MEX,Argentina,ARG,0,0,0,6,0,0,6,0,0,0,0,0,0,0,6
2022,Mali,MLI,Argentina,ARG,0,0,0,0,0,0,0,0,0,0,9,0,0,9,9
2022,Morocco,MAR,Argentina,ARG,0,0,0,0,0,0,0,0,0,0,9,0,0,9,15
2022,Nepal,NPL,Argentina,ARG,0,0,0,0,0,0,0,0,0,0,0,0,0,0,5
2022,Nicaragua,NIC,Argentina,ARG,0,0,0,17,0,0,17,0,0,0,17,0,0,17,34
2022,Nigeria,NGA,Argentina,ARG,0,0,6,16,0,0,22,0,0,0,55,5,0,60,115
2022,Pakistan,PAK,Argentina,ARG,0,0,5,8,0,0,13,0,0,5,30,0,0,35,62
2022,Paraguay,PRY,Argentina,ARG,0,0,5,16,0,0,21,0,0,0,5,7,0,12,33
2022,Peru,PER,Argentina,ARG,30,0,0,219,73,0,322,26,0,5,203,88,0,322,649
2022,Philippines,PHL,Argentina,ARG,0,0,0,5,0,0,5,0,0,0,0,0,0,0,5
2022,Romania,ROU,Argentina,ARG,0,0,0,16,5,0,21,0,0,0,24,6,0,30,51
2022,South Africa,ZAF,Argentina,ARG,0,0,0,0,0,0,0,0,0,0,9,0,0,9,17
2022,Russian Federation,RUS,Argentina,ARG,5,15,5,188,17,0,230,6,13,13,242,13,0,287,549
2022,El Salvador,SLV,Argentina,ARG,0,0,5,28,0,0,33,0,0,0,45,0,0,45,85
2022,Senegal,SEN,Argentina,ARG,0,0,0,28,0,0,28,0,0,0,314,5,0,319,1285
2022,Sierra Leone,SLE,Argentina,ARG,0,0,0,0,0,0,0,0,0,0,37,5,0,42,47
2022,Somalia,SOM,Argentina,ARG,0,0,0,0,0,0,0,0,0,0,0,5,0,5,5
2022,Spain,ESP,Argentina,ARG,0,0,0,5,0,0,5,0,0,0,0,0,0,0,10
2022,Sudan,SDN,Argentina,ARG,0,0,0,0,0,0,0,0,0,0,5,0,0,5,5
2022,Syrian Arab Rep.,SYR,Argentina,ARG,0,13,17,141,34,0,205,5,16,37,232,34,0,324,560
2022,Tunisia,TUN,Argentina,ARG,0,0,0,5,0,0,5,0,0,0,0,0,0,0,5
2022,Türkiye,TUR,Argentina,ARG,0,0,0,0,0,0,0,0,0,0,7,0,0,7,7
2022,Unknown ,UNK,Argentina,ARG,0,6,0,9,0,0,15,0,0,6,19,0,642,667,687
2022,Ukraine,UKR,Argentina,ARG,0,0,6,55,15,0,76,0,6,5,65,7,0,83,180
2022,United States of America,USA,Argentina,ARG,0,0,0,0,0,0,0,0,7,0,5,0,0,12,17
2022,Venezuela (Bolivarian Republic of),VEN,Argentina,ARG,81,395,222,68996,157,14049,83900,93,468,207,69885,99,16390,87142,171050
2022,Yemen,YEM,Argentina,ARG,0,0,0,18,0,0,18,0,0,0,14,0,0,14,32
2022,Afghanistan,AFG,Armenia,ARM,0,0,0,0,0,0,0,0,0,0,0,0,0,0,9
2022,Egypt,EGY,Armenia,ARM,5,0,0,0,0,0,5,0,0,0,0,0,0,0,29
2022,Azerbaijan,AZE,Armenia,ARM,0,0,0,432,233,0,665,0,0,0,373,146,24,543,27938
2022,Congo,COG,Armenia,ARM,0,0,0,0,0,0,0,0,0,0,5,0,0,5,5
2022,Cuba,CUB,Armenia,ARM,0,0,0,0,0,0,0,0,0,0,5,0,0,5,22
2022,Palestinian,PSE,Armenia,ARM,0,0,0,0,0,0,0,0,0,0,7,0,0,7,7
2022,Georgia,GEO,Armenia,ARM,0,0,0,0,0,0,0,0,0,0,0,0,9,9,14
2022,Haiti,HTI,Armenia,ARM,0,0,0,0,0,0,0,0,0,0,0,0,0,0,5
2022,Cote d'Ivoire,CIV,Armenia,ARM,0,0,0,0,0,0,0,0,0,0,6,0,0,6,6
2022,India,IND,Armenia,ARM,0,0,0,0,0,0,0,0,0,0,0,0,0,0,5
2022,Iran (Islamic Rep. of),IRN,Armenia,ARM,0,0,0,0,0,0,0,0,0,0,0,0,0,0,287
2022,Iraq,IRQ,Armenia,ARM,0,0,0,0,0,0,0,0,0,0,0,0,0,0,1307
2022,Lebanon,LBN,Armenia,ARM,0,0,0,10,0,0,10,0,0,0,11,5,0,16,26
2022,Myanmar,MMR,Armenia,ARM,0,0,0,0,0,0,0,0,0,0,0,0,0,0,5
2022,Nigeria,NGA,Armenia,ARM,0,0,0,0,0,0,0,0,0,0,6,0,5,11,11
2022,Pakistan,PAK,Armenia,ARM,0,0,0,0,0,0,0,0,0,0,0,0,0,0,6
2022,Russian Federation,RUS,Armenia,ARM,0,0,0,0,0,0,0,0,0,0,0,0,0,0,20
2022,Syrian Arab Rep.,SYR,Armenia,ARM,25,40,32,188,49,10,344,23,41,48,244,55,9,420,4912
2022,Türkiye,TUR,Armenia,ARM,0,0,0,5,0,0,5,0,0,0,12,0,0,12,35
2022,Unknown ,UNK,Armenia,ARM,0,0,0,0,0,0,0,0,0,0,0,0,0,0,5
2022,Ukraine,UKR,Armenia,ARM,0,0,0,0,0,0,0,0,0,0,0,0,0,0,528
2022,Yemen,YEM,Armenia,ARM,0,0,0,5,0,0,5,0,0,0,16,0,0,16,27
2022,Zimbabwe,ZWE,Armenia,ARM,0,0,0,0,0,0,0,0,0,0,0,0,0,0,5
2022,Afghanistan,AFG,Australia,AUS,0,0,0,5,0,0,5,0,0,0,23,0,0,23,11290
2022,Albania,ALB,Australia,AUS,0,0,0,0,0,0,0,0,0,0,0,0,0,0,134
2022,Algeria,DZA,Australia,AUS,0,0,0,0,0,0,0,0,0,0,0,0,0,0,31
2022,Angola,AGO,Australia,AUS,0,0,0,0,0,0,0,0,0,0,0,0,0,0,5
2022,Egypt,EGY,Australia,AUS,0,0,0,0,0,0,0,0,0,0,0,0,0,0,1338
2022,Argentina,ARG,Australia,AUS,0,0,0,0,0,0,0,0,0,0,0,0,0,0,22
2022,Azerbaijan,AZE,Australia,AUS,0,0,0,0,0,0,0,0,0,0,0,0,0,0,22
2022,Bahrain,BHR,Australia,AUS,0,0,0,0,0,0,0,0,0,0,0,0,0,0,43
2022,Burundi,BDI,Australia,AUS,0,0,0,0,0,0,0,0,0,0,0,0,0,0,82
2022,Belgium,BEL,Australia,AUS,0,0,0,0,0,0,0,0,0,0,0,0,0,0,6
2022,Bangladesh,BGD,Australia,AUS,0,5,0,0,0,0,5,0,0,0,31,0,0,31,1795
2022,Bhutan,BTN,Australia,AUS,0,0,0,0,0,0,0,0,0,0,0,0,0,0,27
2022,Belarus,BLR,Australia,AUS,0,0,0,0,0,0,0,0,0,0,0,0,0,0,7
2022,Brazil,BRA,Australia,AUS,0,0,0,0,0,0,0,0,0,0,0,0,0,0,239
2022,Brunei Darussalam,BRN,Australia,AUS,0,0,0,0,0,0,0,0,0,0,0,0,0,0,14
2022,Bosnia and Herzegovina,BIH,Australia,AUS,0,0,0,0,0,0,0,0,0,0,0,0,0,0,5
2022,Cambodia,KHM,Australia,AUS,0,0,0,0,0,0,0,0,0,0,0,0,0,0,672
2022,Canada,CAN,Australia,AUS,0,0,0,0,0,0,0,0,0,0,0,0,0,0,5
2022,China,CHN,Australia,AUS,0,0,0,0,0,0,0,0,0,0,0,0,0,0,16444
2022,Chile,CHL,Australia,AUS,0,0,0,0,0,0,0,0,0,0,0,0,0,0,74
2022,Cameroon,CMR,Australia,AUS,0,0,0,0,0,0,0,0,0,0,0,0,0,0,90
2022,Congo,COG,Australia,AUS,0,0,0,0,0,0,0,0,0,0,0,0,0,0,52
2022,Dem. Rep. of the Congo,COD,Australia,AUS,0,0,0,0,0,0,0,0,0,0,0,0,0,0,109
2022,Colombia,COL,Australia,AUS,0,0,0,0,0,0,0,0,0,0,0,0,0,0,443
2022,Cuba,CUB,Australia,AUS,0,0,0,0,0,0,0,0,0,0,0,0,0,0,9
2022,Eritrea,ERI,Australia,AUS,0,0,0,0,0,0,0,0,0,0,0,0,0,0,124
2022,Estonia,EST,Australia,AUS,0,0,0,0,0,0,0,0,0,0,0,0,0,0,5
2022,Ethiopia,ETH,Australia,AUS,0,0,0,0,0,0,0,0,0,0,0,0,0,0,585
2022,Fiji,FJI,Australia,AUS,0,0,0,0,0,0,0,0,0,0,0,0,0,0,2973
2022,France,FRA,Australia,AUS,0,0,0,0,0,0,0,0,0,0,0,0,0,0,26
2022,Gambia,GMB,Australia,AUS,0,0,0,0,0,0,0,0,0,0,0,0,0,0,16
2022,Palestinian,PSE,Australia,AUS,0,0,0,0,0,0,0,0,0,0,0,0,0,0,663
2022,United Kingdom of Great Britain and Northern Ireland,GBR,Australia,AUS,0,0,0,0,0,0,0,0,0,0,0,0,0,0,112
2022,Georgia,GEO,Australia,AUS,0,0,0,0,0,0,0,0,0,0,0,0,0,0,46
2022,Germany,DEU,Australia,AUS,0,0,0,0,0,0,0,0,0,0,0,0,0,0,15
2022,Ghana,GHA,Australia,AUS,0,0,0,0,0,0,0,0,0,0,0,0,0,0,210
2022,Greece,GRC,Australia,AUS,0,0,0,0,0,0,0,0,0,0,0,0,0,0,57
2022,Guinea,GIN,Australia,AUS,0,0,0,0,0,0,0,0,0,0,0,0,0,0,14
2022,"China, Hong Kong SAR",HKG,Australia,AUS,0,0,0,0,0,0,0,0,0,0,0,0,0,0,520
2022,Honduras,HND,Australia,AUS,0,0,0,0,0,0,0,0,0,0,0,0,0,0,12
2022,India,IND,Australia,AUS,0,0,0,0,0,0,0,0,0,0,10,0,0,10,8600
2022,Indonesia,IDN,Australia,AUS,5,0,0,5,0,0,10,0,0,0,0,0,0,0,3115
2022,Ireland,IRL,Australia,AUS,0,0,0,0,0,0,0,0,0,0,0,0,0,0,96
2022,Iran (Islamic Rep. of),IRN,Australia,AUS,17,28,25,163,9,0,242,7,43,19,270,0,7,346,16332
2022,Iraq,IRQ,Australia,AUS,0,0,0,12,0,0,12,0,0,0,60,0,0,60,5436
2022,Israel,ISR,Australia,AUS,0,0,0,0,0,0,0,0,0,0,0,0,0,0,23
2022,Italy,ITA,Australia,AUS,0,0,0,0,0,0,0,0,0,0,0,0,0,0,63
2022,Jamaica,JAM,Australia,AUS,0,0,0,0,0,0,0,0,0,0,0,0,0,0,5
2022,Jordan,JOR,Australia,AUS,0,0,0,0,0,0,0,0,0,0,0,0,0,0,334
2022,Japan,JPN,Australia,AUS,0,0,0,0,0,0,0,0,0,0,0,0,0,0,33
2022,Kazakhstan,KAZ,Australia,AUS,0,0,0,0,0,0,0,0,0,0,0,0,0,0,5
2022,Kenya,KEN,Australia,AUS,0,0,0,0,0,0,0,0,0,0,0,0,0,0,472
2022,Kyrgyzstan,KGZ,Australia,AUS,0,0,0,0,0,0,0,0,0,0,0,0,0,0,17
2022,Kiribati,KIR,Australia,AUS,0,0,0,0,0,0,0,0,0,0,0,0,0,0,25
2022,Rep. of Korea,KOR,Australia,AUS,0,0,0,0,0,0,0,0,0,0,0,0,0,0,382
2022,Dem. People's Rep. of Korea,PRK,Australia,AUS,0,0,0,0,0,0,0,0,0,0,0,0,0,0,9
2022,Kuwait,KWT,Australia,AUS,0,0,0,0,0,0,0,0,0,0,0,0,0,0,24
2022,Lao People's Dem. Rep.,LAO,Australia,AUS,0,0,0,0,0,0,0,0,0,0,0,0,0,0,288
2022,Liberia,LBR,Australia,AUS,0,0,0,0,0,0,0,0,0,0,0,0,0,0,64
2022,Libya,LBY,Australia,AUS,0,0,0,0,0,0,0,0,0,0,0,0,0,0,1209
2022,Lebanon,LBN,Australia,AUS,0,5,0,6,0,0,11,0,0,0,6,0,0,6,1545
2022,Sri Lanka,LKA,Australia,AUS,0,5,5,13,0,0,23,0,5,0,39,0,0,44,7310
2022,"China, Macao SAR",MAC,Australia,AUS,0,0,0,0,0,0,0,0,0,0,0,0,0,0,5
2022,North Macedonia,MKD,Australia,AUS,0,0,0,0,0,0,0,0,0,0,0,0,0,0,94
2022,Rep. of Moldova,MDA,Australia,AUS,0,0,0,0,0,0,0,0,0,0,0,0,0,0,5
2022,Maldives,MDV,Australia,AUS,0,0,0,0,0,0,0,0,0,0,0,0,0,0,29
2022,Mexico,MEX,Australia,AUS,0,0,0,0,0,0,0,0,0,0,0,0,0,0,53
2022,Malaysia,MYS,Australia,AUS,0,0,0,5,0,0,5,0,0,0,0,0,0,0,19168
2022,Mongolia,MNG,Australia,AUS,0,0,0,0,0,0,0,0,0,0,0,0,0,0,413
2022,Morocco,MAR,Australia,AUS,0,0,0,0,0,0,0,0,0,0,0,0,0,0,36
2022,Mozambique,MOZ,Australia,AUS,0,0,0,0,0,0,0,0,0,0,0,0,0,0,10
2022,Mauritius,MUS,Australia,AUS,0,0,0,0,0,0,0,0,0,0,0,0,0,0,147
2022,Myanmar,MMR,Australia,AUS,0,0,5,15,5,0,25,0,5,0,28,0,0,33,1724
2022,Nepal,NPL,Australia,AUS,0,0,0,0,0,0,0,0,0,0,5,0,0,5,901
2022,Nigeria,NGA,Australia,AUS,0,0,0,0,0,0,0,0,0,0,0,0,0,0,828
2022,Nauru,NRU,Australia,AUS,0,0,0,0,0,0,0,0,0,0,0,0,0,0,24
2022,New Zealand,NZL,Australia,AUS,0,0,0,0,0,0,0,0,0,0,0,0,0,0,61
2022,Oman,OMN,Australia,AUS,0,0,0,0,0,0,0,0,0,0,0,0,0,0,5
2022,Pakistan,PAK,Australia,AUS,0,0,0,0,0,0,0,0,0,0,38,0,0,38,7549
2022,Peru,PER,Australia,AUS,0,0,0,0,0,0,0,0,0,0,0,0,0,0,126
2022,Philippines,PHL,Australia,AUS,0,0,0,0,0,0,0,0,0,0,0,0,0,0,1676
2022,Papua New Guinea,PNG,Australia,AUS,0,0,0,0,0,0,0,0,0,0,0,0,0,0,1209
2022,Poland,POL,Australia,AUS,0,0,0,0,0,0,0,0,0,0,0,0,0,0,26
2022,Portugal,PRT,Australia,AUS,0,0,0,0,0,0,0,0,0,0,0,0,0,0,12
2022,Romania,ROU,Australia,AUS,0,0,0,0,0,0,0,0,0,0,0,0,0,0,12
2022,South Africa,ZAF,Australia,AUS,0,0,0,0,0,0,0,0,0,0,0,0,0,0,525
2022,Russian Federation,RUS,Australia,AUS,0,0,0,0,0,0,0,0,0,0,0,0,0,0,201
2022,Rwanda,RWA,Australia,AUS,0,0,0,0,0,0,0,0,0,0,0,0,0,0,144
2022,El Salvador,SLV,Australia,AUS,0,0,0,0,0,0,0,0,0,0,0,0,0,0,43
2022,Saudi Arabia,SAU,Australia,AUS,0,0,0,0,0,0,0,0,0,0,0,0,0,0,268
2022,Singapore,SGP,Australia,AUS,0,0,0,0,0,0,0,0,0,0,0,0,0,0,50
2022,Sierra Leone,SLE,Australia,AUS,0,0,0,0,0,0,0,0,0,0,0,0,0,0,153
2022,Solomon Islands,SLB,Australia,AUS,0,0,0,0,0,0,0,0,0,0,0,0,0,0,588
2022,Somalia,SOM,Australia,AUS,12,0,0,30,0,0,42,7,6,0,27,0,0,40,809
2022,Serbia and Kosovo: S/RES/1244 (1999),SRB,Australia,AUS,0,0,0,0,0,0,0,0,0,0,0,0,0,0,22
2022,Viet Nam,VNM,Australia,AUS,0,0,0,0,0,0,0,0,0,0,0,0,0,0,4026
2022,South Sudan,SSD,Australia,AUS,0,0,0,0,0,0,0,0,0,0,0,0,0,0,60
2022,Stateless,XXA,Australia,AUS,0,9,5,9,0,0,23,5,5,5,32,0,0,47,5766
2022,Sudan,SDN,Australia,AUS,0,0,0,0,0,0,0,0,0,0,25,0,0,25,943
2022,Eswatini,SWZ,Australia,AUS,0,0,0,0,0,0,0,0,0,0,0,0,0,0,22
2022,Sweden,SWE,Australia,AUS,0,0,0,0,0,0,0,0,0,0,0,0,0,0,10
2022,Syrian Arab Rep.,SYR,Australia,AUS,0,0,0,0,0,0,0,0,0,0,5,0,0,5,617
2022,United Rep. of Tanzania,TZA,Australia,AUS,0,0,0,0,0,0,0,0,0,0,0,0,0,0,47
2022,Thailand,THA,Australia,AUS,0,0,0,0,0,0,0,0,0,0,0,0,0,0,2266
2022,Tibetan,TIB,Australia,AUS,0,0,0,0,0,0,0,0,0,0,0,0,0,0,10
2022,Timor-Leste,TLS,Australia,AUS,0,0,0,0,0,0,0,0,0,0,0,0,0,0,644
2022,Tonga,TON,Australia,AUS,0,0,0,0,0,0,0,0,0,0,0,0,0,0,1328
2022,Tunisia,TUN,Australia,AUS,0,0,0,0,0,0,0,0,0,0,0,0,0,0,12
2022,Türkiye,TUR,Australia,AUS,0,0,0,0,0,0,0,0,0,0,0,0,0,0,1334
2022,United Arab Emirates,ARE,Australia,AUS,0,0,0,0,0,0,0,0,0,0,0,0,0,0,5
2022,Uganda,UGA,Australia,AUS,0,0,0,0,0,0,0,0,0,0,0,0,0,0,156
2022,Unknown ,UNK,Australia,AUS,0,0,0,0,0,0,0,0,0,0,0,0,0,0,2591
2022,Ukraine,UKR,Australia,AUS,0,0,0,0,0,0,0,0,0,0,0,0,0,0,2029
2022,Uruguay,URY,Australia,AUS,0,0,0,0,0,0,0,0,0,0,0,0,0,0,5
2022,United States of America,USA,Australia,AUS,0,0,0,0,0,0,0,0,0,0,0,0,0,0,80
2022,Uzbekistan,UZB,Australia,AUS,0,0,0,0,0,0,0,0,0,0,0,0,0,0,78
2022,Vanuatu,VUT,Australia,AUS,0,0,0,0,0,0,0,0,0,0,0,0,0,0,583
2022,Venezuela (Bolivarian Republic of),VEN,Australia,AUS,0,0,0,0,0,0,0,0,0,0,0,0,0,0,504
2022,Samoa,WSM,Australia,AUS,0,0,0,0,0,0,0,0,0,0,0,0,0,0,398
2022,Yemen,YEM,Australia,AUS,0,0,0,0,0,0,0,0,0,0,0,0,0,0,316
2022,Zambia,ZMB,Australia,AUS,0,0,0,0,0,0,0,0,0,0,0,0,0,0,45
2022,Zimbabwe,ZWE,Australia,AUS,0,0,0,0,0,0,0,0,0,0,0,0,0,0,465
2022,Afghanistan,AFG,Austria,AUT,0,0,0,0,0,917,917,0,0,0,0,0,6502,6502,52701
2022,Albania,ALB,Austria,AUT,0,0,0,0,0,12,12,0,0,0,0,0,12,12,73
2022,Algeria,DZA,Austria,AUT,0,0,0,0,0,15,15,0,0,0,0,0,196,196,238
2022,Angola,AGO,Austria,AUT,0,0,0,0,0,0,0,0,0,0,0,0,0,0,43
2022,Egypt,EGY,Austria,AUT,0,0,0,0,0,35,35,0,0,0,0,0,344,344,600
2022,Armenia,ARM,Austria,AUT,0,0,0,0,0,55,55,0,0,0,0,0,45,45,395
2022,Azerbaijan,AZE,Austria,AUT,0,0,0,0,0,22,22,0,0,0,0,0,43,43,216
2022,Burundi,BDI,Austria,AUT,0,0,0,0,0,21,21,0,0,0,0,0,40,40,79
2022,Benin,BEN,Austria,AUT,0,0,0,0,0,0,0,0,0,0,0,0,0,0,11
2022,Bangladesh,BGD,Austria,AUT,0,0,0,0,0,5,5,0,0,0,0,0,448,448,835
2022,Burkina Faso,BFA,Austria,AUT,0,0,0,0,0,0,0,0,0,0,0,0,0,0,13
2022,Belarus,BLR,Austria,AUT,0,0,0,0,0,14,14,0,0,0,0,0,14,14,65
2022,Bosnia and Herzegovina,BIH,Austria,AUT,0,0,0,0,0,0,0,0,0,0,0,0,0,0,65
2022,Chad,TCD,Austria,AUT,0,0,0,0,0,0,0,0,0,0,0,0,0,0,5
2022,China,CHN,Austria,AUT,0,0,0,0,0,54,54,0,0,0,0,0,54,54,785
2022,Cameroon,CMR,Austria,AUT,0,0,0,0,0,16,16,0,0,0,0,0,57,57,266
2022,Congo,COG,Austria,AUT,0,0,0,0,0,6,6,0,0,0,0,0,6,6,90
2022,Dem. Rep. of the Congo,COD,Austria,AUT,0,0,0,0,0,24,24,0,0,0,0,0,43,43,392
2022,Colombia,COL,Austria,AUT,0,0,0,0,0,14,14,0,0,0,0,0,14,14,33
2022,Cuba,CUB,Austria,AUT,0,0,0,0,0,5,5,0,0,0,0,0,9,9,29
2022,Eritrea,ERI,Austria,AUT,0,0,0,0,0,0,0,0,0,0,0,0,0,0,554
2022,Ethiopia,ETH,Austria,AUT,0,0,0,0,0,17,17,0,0,0,0,0,26,26,305
2022,Gabon,GAB,Austria,AUT,0,0,0,0,0,0,0,0,0,0,0,0,0,0,5
2022,Gambia,GMB,Austria,AUT,0,0,0,0,0,5,5,0,0,0,0,0,27,27,150
2022,United Kingdom of Great Britain and Northern Ireland,GBR,Austria,AUT,0,0,0,0,0,0,0,0,0,0,0,0,0,0,10
2022,Georgia,GEO,Austria,AUT,0,0,0,0,0,118,118,0,0,0,0,0,172,172,613
2022,Ghana,GHA,Austria,AUT,0,0,0,0,0,6,6,0,0,0,0,0,16,16,38
2022,Guinea-Bissau,GNB,Austria,AUT,0,0,0,0,0,0,0,0,0,0,0,0,0,0,10
2022,Guatemala,GTM,Austria,AUT,0,0,0,0,0,0,0,0,0,0,0,0,0,0,6
2022,Guinea,GIN,Austria,AUT,0,0,0,0,0,5,5,0,0,0,0,0,15,15,149
2022,Cote d'Ivoire,CIV,Austria,AUT,0,0,0,0,0,8,8,0,0,0,0,0,0,0,53
2022,India,IND,Austria,AUT,0,0,0,0,0,186,186,0,0,0,0,0,7460,7460,7684
2022,Iran (Islamic Rep. of),IRN,Austria,AUT,0,0,0,0,0,315,315,0,0,0,0,0,526,526,8505
2022,Iraq,IRQ,Austria,AUT,0,0,0,0,0,284,284,0,0,0,0,0,811,811,11435
2022,Israel,ISR,Austria,AUT,0,0,0,0,0,0,0,0,0,0,0,0,0,0,15
2022,Jordan,JOR,Austria,AUT,0,0,0,0,0,26,26,0,0,0,0,0,67,67,178
2022,Kazakhstan,KAZ,Austria,AUT,0,0,0,0,0,5,5,0,0,0,0,0,13,13,126
2022,Kenya,KEN,Austria,AUT,0,0,0,0,0,8,8,0,0,0,0,0,0,0,25
2022,Kyrgyzstan,KGZ,Austria,AUT,0,0,0,0,0,10,10,0,0,0,0,0,14,14,141
2022,Kuwait,KWT,Austria,AUT,0,0,0,0,0,0,0,0,0,0,0,0,0,0,14
2022,Liberia,LBR,Austria,AUT,0,0,0,0,0,0,0,0,0,0,0,0,0,0,10
2022,Libya,LBY,Austria,AUT,0,0,0,0,0,10,10,0,0,0,0,0,61,61,221
2022,Lebanon,LBN,Austria,AUT,0,0,0,0,0,41,41,0,0,0,0,0,105,105,273
2022,Sri Lanka,LKA,Austria,AUT,0,0,0,0,0,6,6,0,0,0,0,0,21,21,104
2022,Mauritania,MRT,Austria,AUT,0,0,0,0,0,0,0,0,0,0,0,0,0,0,5
2022,North Macedonia,MKD,Austria,AUT,0,0,0,0,0,15,15,0,0,0,0,0,29,29,61
2022,Rep. of Moldova,MDA,Austria,AUT,0,0,0,0,0,47,47,0,0,0,0,0,66,66,131
2022,Mali,MLI,Austria,AUT,0,0,0,0,0,0,0,0,0,0,0,0,0,0,26
2022,Montenegro,MNE,Austria,AUT,0,0,0,0,0,0,0,0,0,0,0,0,0,0,5
2022,Mongolia,MNG,Austria,AUT,0,0,0,0,0,19,19,0,0,0,0,0,19,19,147
2022,Morocco,MAR,Austria,AUT,0,0,0,0,0,44,44,0,0,0,0,0,3922,3922,4021
2022,Myanmar,MMR,Austria,AUT,0,0,0,0,0,0,0,0,0,0,0,0,0,0,49
2022,Namibia,NAM,Austria,AUT,0,0,0,0,0,0,0,0,0,0,0,0,0,0,5
2022,Nepal,NPL,Austria,AUT,0,0,0,0,0,15,15,0,0,0,0,0,54,54,86
2022,Nicaragua,NIC,Austria,AUT,0,0,0,0,0,0,0,0,0,0,0,0,0,0,10
2022,Nigeria,NGA,Austria,AUT,0,0,0,0,0,54,54,0,0,0,0,0,152,152,664
2022,Pakistan,PAK,Austria,AUT,0,0,0,0,0,19,19,0,0,0,0,0,2004,2004,2445
2022,Philippines,PHL,Austria,AUT,0,0,0,0,0,8,8,0,0,0,0,0,0,0,27
2022,Russian Federation,RUS,Austria,AUT,0,0,0,0,0,355,355,0,0,0,0,0,481,481,7112
2022,Rwanda,RWA,Austria,AUT,0,0,0,0,0,0,0,0,0,0,0,0,0,0,18
2022,Saudi Arabia,SAU,Austria,AUT,0,0,0,0,0,0,0,0,0,0,0,0,0,0,8
2022,Senegal,SEN,Austria,AUT,0,0,0,0,0,0,0,0,0,0,0,0,0,0,24
2022,Sierra Leone,SLE,Austria,AUT,0,0,0,0,0,0,0,0,0,0,0,0,0,0,18
2022,Somalia,SOM,Austria,AUT,0,0,0,0,0,559,559,0,0,0,0,0,1695,1695,11601
2022,Serbia and Kosovo: S/RES/1244 (1999),SRB,Austria,AUT,0,0,0,0,0,39,39,0,0,0,0,0,57,57,507
2022,Viet Nam,VNM,Austria,AUT,0,0,0,0,0,7,7,0,0,0,0,0,0,0,7
2022,South Sudan,SSD,Austria,AUT,0,0,0,0,0,0,0,0,0,0,0,0,0,0,6
2022,Stateless,XXA,Austria,AUT,0,0,0,0,0,0,0,0,0,0,0,0,0,0,1972
2022,Sudan,SDN,Austria,AUT,0,0,0,0,0,15,15,0,0,0,0,0,63,63,376
2022,Syrian Arab Rep.,SYR,Austria,AUT,0,0,0,0,0,2572,2572,0,0,0,0,0,14672,14672,91167
2022,United Rep. of Tanzania,TZA,Austria,AUT,0,0,0,0,0,0,0,0,0,0,0,0,0,0,10
2022,Thailand,THA,Austria,AUT,0,0,0,0,0,5,5,0,0,0,0,0,0,0,5
2022,Tajikistan,TJK,Austria,AUT,0,0,0,0,0,24,24,0,0,0,0,0,27,27,318
2022,Turkmenistan,TKM,Austria,AUT,0,0,0,0,0,0,0,0,0,0,0,0,0,0,9
2022,Togo,TGO,Austria,AUT,0,0,0,0,0,0,0,0,0,0,0,0,0,0,13
2022,Tunisia,TUN,Austria,AUT,0,0,0,0,0,222,222,0,0,0,0,0,2256,2256,2496
2022,Türkiye,TUR,Austria,AUT,0,0,0,0,0,578,578,0,0,0,0,0,2286,2286,3620
2022,Uganda,UGA,Austria,AUT,0,0,0,0,0,9,9,0,0,0,0,0,0,0,46
2022,Unknown ,UNK,Austria,AUT,0,0,0,0,0,0,0,0,0,0,0,0,0,0,5974
2022,Ukraine,UKR,Austria,AUT,0,0,0,0,0,60985,60985,0,0,0,0,0,28799,28799,90111
2022,United States of America,USA,Austria,AUT,0,0,0,0,0,0,0,0,0,0,0,0,0,0,12
2022,Uzbekistan,UZB,Austria,AUT,0,0,0,0,0,30,30,0,0,0,0,0,38,38,115
2022,Venezuela (Bolivarian Republic of),VEN,Austria,AUT,0,0,0,0,0,37,37,0,0,0,0,0,20,20,161
2022,Yemen,YEM,Austria,AUT,0,0,0,0,0,15,15,0,0,0,0,0,165,165,742
2022,Zambia,ZMB,Austria,AUT,0,0,0,0,0,0,0,0,0,0,0,0,0,0,5
2022,Zimbabwe,ZWE,Austria,AUT,0,0,0,0,0,7,7,0,0,0,0,0,0,0,7
2022,Afghanistan,AFG,Azerbaijan,AZE,51,67,43,298,8,0,467,38,80,67,498,26,0,709,1176
2022,Palestinian,PSE,Azerbaijan,AZE,0,0,0,0,0,0,0,0,0,0,5,0,0,5,5
2022,Iran (Islamic Rep. of),IRN,Azerbaijan,AZE,0,0,0,16,0,0,16,0,0,0,41,8,0,49,65
2022,Iraq,IRQ,Azerbaijan,AZE,0,0,0,5,0,0,5,0,0,0,5,0,0,5,10
2022,Libya,LBY,Azerbaijan,AZE,0,0,0,0,0,0,0,0,5,0,0,0,0,5,5
2022,Pakistan,PAK,Azerbaijan,AZE,0,0,15,30,0,0,45,0,0,11,36,0,0,47,92
2022,Russian Federation,RUS,Azerbaijan,AZE,9,25,25,78,9,0,146,6,33,20,98,12,0,169,315
2022,Syrian Arab Rep.,SYR,Azerbaijan,AZE,0,0,7,6,0,0,13,0,0,5,17,0,0,22,35
2022,Ukraine,UKR,Azerbaijan,AZE,0,6,5,45,0,2653,2709,8,9,0,9,0,2112,2138,4847
2022,Uzbekistan,UZB,Azerbaijan,AZE,5,0,0,0,0,0,5,0,0,0,0,0,0,0,5
2022,Yemen,YEM,Azerbaijan,AZE,0,0,0,5,0,0,5,0,0,0,6,0,0,6,11
2022,Egypt,EGY,Bahrain,BHR,0,0,0,5,0,0,5,0,0,0,0,0,0,0,5
2022,Iraq,IRQ,Bahrain,BHR,0,15,18,109,18,0,160,0,19,22,123,23,0,187,347
2022,Jordan,JOR,Bahrain,BHR,0,0,0,0,0,0,0,0,0,6,0,0,0,6,6
2022,Syrian Arab Rep.,SYR,Bahrain,BHR,0,5,0,0,0,0,5,0,0,0,0,0,0,0,5
2022,Yemen,YEM,Bahrain,BHR,0,5,0,9,0,0,14,0,0,0,0,0,0,0,14
2022,Central African Rep.,CAF,Burundi,BDI,0,7,0,0,0,0,7,0,0,0,0,0,0,0,7
2022,Dem. Rep. of the Congo,COD,Burundi,BDI,6537,9481,7560,19521,1202,0,44301,6882,9688,7565,18077,994,0,43206,87507
2022,Mali,MLI,Burundi,BDI,0,0,0,5,0,0,5,0,0,0,7,0,0,7,12
2022,South Africa,ZAF,Burundi,BDI,0,0,0,0,0,0,0,0,0,5,0,0,0,5,5
2022,Rwanda,RWA,Burundi,BDI,24,100,87,249,28,0,488,46,79,85,265,70,0,545,1033
2022,Somalia,SOM,Burundi,BDI,0,0,0,0,0,0,0,0,0,0,5,0,0,5,5
2022,Uganda,UGA,Burundi,BDI,6,0,0,5,0,0,11,0,0,6,0,0,0,6,17
2022,Afghanistan,AFG,Belgium,BEL,0,0,0,0,0,2363,2363,0,0,0,0,0,13575,13575,15938
2022,Albania,ALB,Belgium,BEL,0,0,0,0,0,436,436,0,0,0,0,0,472,472,908
2022,Algeria,DZA,Belgium,BEL,0,0,0,0,0,111,111,0,0,0,0,0,253,253,364
2022,Angola,AGO,Belgium,BEL,0,0,0,0,0,138,138,0,0,0,0,0,132,132,270
2022,Egypt,EGY,Belgium,BEL,0,0,0,0,0,56,56,0,0,0,0,0,189,189,245
2022,Armenia,ARM,Belgium,BEL,0,0,0,0,0,405,405,0,0,0,0,0,430,430,835
2022,Azerbaijan,AZE,Belgium,BEL,0,0,0,0,0,107,107,0,0,0,0,0,135,135,242
2022,Burundi,BDI,Belgium,BEL,0,0,0,0,0,2176,2176,0,0,0,0,0,2525,2525,4701
2022,Benin,BEN,Belgium,BEL,0,0,0,0,0,57,57,0,0,0,0,0,76,76,133
2022,Bangladesh,BGD,Belgium,BEL,0,0,0,0,0,10,10,0,0,0,0,0,30,30,40
2022,Burkina Faso,BFA,Belgium,BEL,0,0,0,0,0,111,111,0,0,0,0,0,138,138,249
2022,Belarus,BLR,Belgium,BEL,0,0,0,0,0,135,135,0,0,0,0,0,155,155,290
2022,Brazil,BRA,Belgium,BEL,0,0,0,0,0,20,20,0,0,0,0,0,38,38,58
2022,Bosnia and Herzegovina,BIH,Belgium,BEL,0,0,0,0,0,62,62,0,0,0,0,0,62,62,124
2022,Bulgaria,BGR,Belgium,BEL,0,0,0,0,0,7,7,0,0,0,0,0,10,10,17
2022,Cambodia,KHM,Belgium,BEL,0,0,0,0,0,5,5,0,0,0,0,0,8,8,18
2022,Central African Rep.,CAF,Belgium,BEL,0,0,0,0,0,37,37,0,0,0,0,0,55,55,92
2022,Chad,TCD,Belgium,BEL,0,0,0,0,0,36,36,0,0,0,0,0,54,54,90
2022,China,CHN,Belgium,BEL,0,0,0,0,0,510,510,0,0,0,0,0,643,643,1153
2022,Chile,CHL,Belgium,BEL,0,0,0,0,0,17,17,0,0,0,0,0,31,31,48
2022,Cameroon,CMR,Belgium,BEL,0,0,0,0,0,608,608,0,0,0,0,0,1098,1098,1706
2022,Congo,COG,Belgium,BEL,0,0,0,0,0,33,33,0,0,0,0,0,42,42,75
2022,Dem. Rep. of the Congo,COD,Belgium,BEL,0,0,0,0,0,1380,1380,0,0,0,0,0,1306,1306,2686
2022,Colombia,COL,Belgium,BEL,0,0,0,0,0,335,335,0,0,0,0,0,395,395,730
2022,Cuba,CUB,Belgium,BEL,0,0,0,0,0,15,15,0,0,0,0,0,20,20,35
2022,Czechia,CZE,Belgium,BEL,0,0,0,0,0,0,0,0,0,0,0,0,5,5,5
2022,Djibouti,DJI,Belgium,BEL,0,0,0,0,0,237,237,0,0,0,0,0,182,182,419
2022,Dominican Rep.,DOM,Belgium,BEL,0,0,0,0,0,0,0,0,0,0,0,0,0,0,5
2022,Ecuador,ECU,Belgium,BEL,0,0,0,0,0,5,5,0,0,0,0,0,10,10,15
2022,Equatorial Guinea,GNQ,Belgium,BEL,0,0,0,0,0,0,0,0,0,0,0,0,0,0,5
2022,Eritrea,ERI,Belgium,BEL,0,0,0,0,0,2192,2192,0,0,0,0,0,4229,4229,6421
2022,Ethiopia,ETH,Belgium,BEL,0,0,0,0,0,157,157,0,0,0,0,0,396,396,553
2022,Gabon,GAB,Belgium,BEL,0,0,0,0,0,30,30,0,0,0,0,0,31,31,61
2022,Gambia,GMB,Belgium,BEL,0,0,0,0,0,35,35,0,0,0,0,0,120,120,155
2022,Palestinian,PSE,Belgium,BEL,0,0,0,0,0,2017,2017,0,0,0,0,0,5860,5860,7877
2022,United Kingdom of Great Britain and Northern Ireland,GBR,Belgium,BEL,0,0,0,0,0,9,9,0,0,0,0,0,7,7,21
2022,Georgia,GEO,Belgium,BEL,0,0,0,0,0,329,329,0,0,0,0,0,619,619,948
2022,Ghana,GHA,Belgium,BEL,0,0,0,0,0,15,15,0,0,0,0,0,81,81,96
2022,Guinea-Bissau,GNB,Belgium,BEL,0,0,0,0,0,5,5,0,0,0,0,0,16,16,21
2022,Guatemala,GTM,Belgium,BEL,0,0,0,0,0,52,52,0,0,0,0,0,81,81,133
2022,Guinea,GIN,Belgium,BEL,0,0,0,0,0,2576,2576,0,0,0,0,0,1924,1924,4500
2022,Haiti,HTI,Belgium,BEL,0,0,0,0,0,10,10,0,0,0,0,0,17,17,27
2022,Honduras,HND,Belgium,BEL,0,0,0,0,0,22,22,0,0,0,0,0,19,19,41
2022,Croatia,HRV,Belgium,BEL,0,0,0,0,0,5,5,0,0,0,0,0,0,0,5
2022,Hungary,HUN,Belgium,BEL,0,0,0,0,0,0,0,0,0,0,0,0,28,28,28
2022,Cote d'Ivoire,CIV,Belgium,BEL,0,0,0,0,0,238,238,0,0,0,0,0,273,273,511
2022,India,IND,Belgium,BEL,0,0,0,0,0,5,5,0,0,0,0,0,23,23,28
2022,Iran (Islamic Rep. of),IRN,Belgium,BEL,0,0,0,0,0,873,873,0,0,0,0,0,1543,1543,2416
2022,Iraq,IRQ,Belgium,BEL,0,0,0,0,0,1624,1624,0,0,0,0,0,3200,3200,4824
2022,Israel,ISR,Belgium,BEL,0,0,0,0,0,0,0,0,0,0,0,0,11,11,11
2022,Italy,ITA,Belgium,BEL,0,0,0,0,0,5,5,0,0,0,0,0,5,5,10
2022,Jamaica,JAM,Belgium,BEL,0,0,0,0,0,0,0,0,0,0,0,0,11,11,11
2022,Jordan,JOR,Belgium,BEL,0,0,0,0,0,47,47,0,0,0,0,0,109,109,156
2022,Japan,JPN,Belgium,BEL,0,0,0,0,0,0,0,0,0,0,0,0,0,0,5
2022,Kazakhstan,KAZ,Belgium,BEL,0,0,0,0,0,51,51,0,0,0,0,0,54,54,105
2022,Kenya,KEN,Belgium,BEL,0,0,0,0,0,16,16,0,0,0,0,0,14,14,30
2022,Kyrgyzstan,KGZ,Belgium,BEL,0,0,0,0,0,82,82,0,0,0,0,0,50,50,132
2022,Dem. People's Rep. of Korea,PRK,Belgium,BEL,0,0,0,0,0,14,14,0,0,0,0,0,14,14,33
2022,Kuwait,KWT,Belgium,BEL,0,0,0,0,0,0,0,0,0,0,0,0,11,11,11
2022,Lao People's Dem. Rep.,LAO,Belgium,BEL,0,0,0,0,0,0,0,0,0,0,0,0,9,9,9
2022,Liberia,LBR,Belgium,BEL,0,0,0,0,0,21,21,0,0,0,0,0,35,35,56
2022,Libya,LBY,Belgium,BEL,0,0,0,0,0,79,79,0,0,0,0,0,213,213,292
2022,Lebanon,LBN,Belgium,BEL,0,0,0,0,0,120,120,0,0,0,0,0,214,214,334
2022,Sri Lanka,LKA,Belgium,BEL,0,0,0,0,0,90,90,0,0,0,0,0,163,163,253
2022,Lithuania,LTU,Belgium,BEL,0,0,0,0,0,0,0,0,0,0,0,0,5,5,5
2022,Madagascar,MDG,Belgium,BEL,0,0,0,0,0,5,5,0,0,0,0,0,0,0,5
2022,Mauritania,MRT,Belgium,BEL,0,0,0,0,0,200,200,0,0,0,0,0,309,309,509
2022,North Macedonia,MKD,Belgium,BEL,0,0,0,0,0,137,137,0,0,0,0,0,157,157,294
2022,Rep. of Moldova,MDA,Belgium,BEL,0,0,0,0,0,384,384,0,0,0,0,0,387,387,771
2022,Mexico,MEX,Belgium,BEL,0,0,0,0,0,0,0,0,0,0,0,0,5,5,5
2022,Mali,MLI,Belgium,BEL,0,0,0,0,0,67,67,0,0,0,0,0,109,109,176
2022,Malawi,MWI,Belgium,BEL,0,0,0,0,0,5,5,0,0,0,0,0,0,0,5
2022,Montenegro,MNE,Belgium,BEL,0,0,0,0,0,8,8,0,0,0,0,0,5,5,18
2022,Mongolia,MNG,Belgium,BEL,0,0,0,0,0,5,5,0,0,0,0,0,5,5,10
2022,Morocco,MAR,Belgium,BEL,0,0,0,0,0,189,189,0,0,0,0,0,416,416,605
2022,Mozambique,MOZ,Belgium,BEL,0,0,0,0,0,5,5,0,0,0,0,0,5,5,10
2022,Myanmar,MMR,Belgium,BEL,0,0,0,0,0,7,7,0,0,0,0,0,0,0,7
2022,Namibia,NAM,Belgium,BEL,0,0,0,0,0,0,0,0,0,0,0,0,0,0,5
2022,Nepal,NPL,Belgium,BEL,0,0,0,0,0,5,5,0,0,0,0,0,0,0,10
2022,Netherlands (Kingdom of the),NLD,Belgium,BEL,0,0,0,0,0,0,0,0,0,0,0,0,0,0,5
2022,Niger,NER,Belgium,BEL,0,0,0,0,0,110,110,0,0,0,0,0,267,267,377
2022,Nicaragua,NIC,Belgium,BEL,0,0,0,0,0,20,20,0,0,0,0,0,33,33,53
2022,Nigeria,NGA,Belgium,BEL,0,0,0,0,0,152,152,0,0,0,0,0,325,325,477
2022,Pakistan,PAK,Belgium,BEL,0,0,0,0,0,116,116,0,0,0,0,0,323,323,439
2022,Panama,PAN,Belgium,BEL,0,0,0,0,0,0,0,0,0,0,0,0,5,5,5
2022,Paraguay,PRY,Belgium,BEL,0,0,0,0,0,0,0,0,0,0,0,0,5,5,5
2022,Peru,PER,Belgium,BEL,0,0,0,0,0,35,35,0,0,0,0,0,46,46,81
2022,Philippines,PHL,Belgium,BEL,0,0,0,0,0,5,5,0,0,0,0,0,5,5,10
2022,Poland,POL,Belgium,BEL,0,0,0,0,0,21,21,0,0,0,0,0,64,64,85
2022,Romania,ROU,Belgium,BEL,0,0,0,0,0,11,11,0,0,0,0,0,29,29,40
2022,South Africa,ZAF,Belgium,BEL,0,0,0,0,0,0,0,0,0,0,0,0,5,5,10
2022,Russian Federation,RUS,Belgium,BEL,0,0,0,0,0,1522,1522,0,0,0,0,0,1744,1744,3266
2022,Rwanda,RWA,Belgium,BEL,0,0,0,0,0,580,580,0,0,0,0,0,590,590,1170
2022,El Salvador,SLV,Belgium,BEL,0,0,0,0,0,500,500,0,0,0,0,0,451,451,951
2022,Saudi Arabia,SAU,Belgium,BEL,0,0,0,0,0,0,0,0,0,0,0,0,10,10,10
2022,Senegal,SEN,Belgium,BEL,0,0,0,0,0,177,177,0,0,0,0,0,455,455,632
2022,Sierra Leone,SLE,Belgium,BEL,0,0,0,0,0,31,31,0,0,0,0,0,53,53,84
2022,Somalia,SOM,Belgium,BEL,0,0,0,0,0,1749,1749,0,0,0,0,0,1714,1714,3463
2022,Spain,ESP,Belgium,BEL,0,0,0,0,0,5,5,0,0,0,0,0,5,5,10
2022,Serbia and Kosovo: S/RES/1244 (1999),SRB,Belgium,BEL,0,0,0,0,0,318,318,0,0,0,0,0,291,291,609
2022,Viet Nam,VNM,Belgium,BEL,0,0,0,0,0,20,20,0,0,0,0,0,51,51,71
2022,South Sudan,SSD,Belgium,BEL,0,0,0,0,0,5,5,0,0,0,0,0,52,52,57
2022,Stateless,XXA,Belgium,BEL,0,0,0,0,0,344,344,0,0,0,0,0,613,613,957
2022,Sudan,SDN,Belgium,BEL,0,0,0,0,0,81,81,0,0,0,0,0,375,375,456
2022,Suriname,SUR,Belgium,BEL,0,0,0,0,0,13,13,0,0,0,0,0,7,7,20
2022,Syrian Arab Rep.,SYR,Belgium,BEL,0,0,0,0,0,7864,7864,0,0,0,0,0,12439,12439,20303
2022,United Rep. of Tanzania,TZA,Belgium,BEL,0,0,0,0,0,35,35,0,0,0,0,0,37,37,72
2022,Tibetan,TIB,Belgium,BEL,0,0,0,0,0,0,0,0,0,0,0,0,5,5,5
2022,Tajikistan,TJK,Belgium,BEL,0,0,0,0,0,27,27,0,0,0,0,0,15,15,42
2022,Turkmenistan,TKM,Belgium,BEL,0,0,0,0,0,0,0,0,0,0,0,0,11,11,16
2022,Togo,TGO,Belgium,BEL,0,0,0,0,0,96,96,0,0,0,0,0,211,211,307
2022,Trinidad and Tobago,TTO,Belgium,BEL,0,0,0,0,0,5,5,0,0,0,0,0,5,5,10
2022,Tunisia,TUN,Belgium,BEL,0,0,0,0,0,62,62,0,0,0,0,0,171,171,233
2022,Türkiye,TUR,Belgium,BEL,0,0,0,0,0,1594,1594,0,0,0,0,0,3462,3462,5056
2022,United Arab Emirates,ARE,Belgium,BEL,0,0,0,0,0,0,0,0,0,0,0,0,7,7,7
2022,Uganda,UGA,Belgium,BEL,0,0,0,0,0,34,34,0,0,0,0,0,24,24,58
2022,Unknown ,UNK,Belgium,BEL,0,0,0,0,0,12120,12120,0,0,0,0,0,13532,13532,25652
2022,Ukraine,UKR,Belgium,BEL,0,0,0,0,0,38659,38659,0,0,0,0,0,24001,24001,62660
2022,United States of America,USA,Belgium,BEL,0,0,0,0,0,5,5,0,0,0,0,0,5,5,10
2022,Uzbekistan,UZB,Belgium,BEL,0,0,0,0,0,39,39,0,0,0,0,0,61,61,100
2022,Venezuela (Bolivarian Republic of),VEN,Belgium,BEL,0,0,0,0,0,422,422,0,0,0,0,0,436,436,858
2022,Yemen,YEM,Belgium,BEL,0,0,0,0,0,86,86,0,0,0,0,0,350,350,436
2022,Zambia,ZMB,Belgium,BEL,0,0,0,0,0,0,0,0,0,0,0,0,0,0,5
2022,Burundi,BDI,Benin,BEN,0,0,0,5,0,0,5,0,0,0,0,0,0,0,5
2022,Burkina Faso,BFA,Benin,BEN,99,125,70,239,19,0,552,121,137,66,177,6,0,507,1059
2022,Central African Rep.,CAF,Benin,BEN,30,64,65,448,11,0,618,24,88,77,549,0,0,738,1356
2022,Chad,TCD,Benin,BEN,0,13,6,18,0,0,37,10,5,6,68,0,0,89,126
2022,Cameroon,CMR,Benin,BEN,5,9,7,55,0,0,76,0,13,5,108,0,0,126,202
2022,Congo,COG,Benin,BEN,0,0,0,5,0,0,5,0,0,0,7,0,0,7,12
2022,Dem. Rep. of the Congo,COD,Benin,BEN,0,14,5,26,0,0,45,0,0,11,35,0,0,46,91
2022,Eritrea,ERI,Benin,BEN,0,0,0,0,0,0,0,0,0,0,5,0,0,5,5
2022,Guinea,GIN,Benin,BEN,0,0,5,0,0,0,5,0,9,0,0,0,0,9,14
2022,Cote d'Ivoire,CIV,Benin,BEN,0,0,0,8,0,0,8,0,0,5,16,0,0,21,29
2022,Liberia,LBR,Benin,BEN,0,0,0,0,0,0,0,0,0,0,5,0,0,5,5
2022,Sri Lanka,LKA,Benin,BEN,0,5,0,0,0,0,5,0,0,5,0,0,0,5,10
2022,Mali,MLI,Benin,BEN,0,0,6,23,0,0,29,0,5,11,30,0,0,46,75
2022,Niger,NER,Benin,BEN,0,12,0,5,0,0,17,0,8,0,17,0,0,25,42
2022,Nigeria,NGA,Benin,BEN,0,0,0,20,0,0,20,0,0,5,20,0,0,25,45
2022,Pakistan,PAK,Benin,BEN,0,0,0,0,0,0,0,0,5,0,0,0,0,5,5
2022,Rwanda,RWA,Benin,BEN,0,0,0,0,0,0,0,0,0,0,5,0,0,5,5
2022,Sudan,SDN,Benin,BEN,0,9,0,0,0,0,9,5,0,0,27,0,0,32,41
2022,Syrian Arab Rep.,SYR,Benin,BEN,0,0,0,11,0,0,11,6,7,0,28,0,0,41,52
2022,Togo,TGO,Benin,BEN,0,0,0,12,0,0,12,0,0,0,16,0,0,16,28
2022,Türkiye,TUR,Benin,BEN,0,0,0,5,0,0,5,0,0,0,5,0,0,5,10
2022,Yemen,YEM,Benin,BEN,0,6,0,5,0,0,11,0,0,0,11,0,0,11,22
2022,Afghanistan,AFG,Bangladesh,BGD,0,0,0,5,0,0,5,0,0,0,0,0,0,0,5
2022,Myanmar,MMR,Bangladesh,BGD,77818,104063,64417,227064,15650,0,489012,81430,108050,69522,184147,20209,0,463358,952370
2022,Somalia,SOM,Bangladesh,BGD,0,0,0,11,0,0,11,0,0,0,22,0,0,22,33
2022,Cambodia,KHM,Bahamas,BHS,0,0,0,0,0,0,0,0,0,0,0,0,0,0,5
2022,Cameroon,CMR,Bahamas,BHS,0,0,0,0,0,0,0,0,0,0,0,0,0,0,5
2022,Cuba,CUB,Bahamas,BHS,0,0,0,0,0,0,0,0,0,0,0,0,0,0,11
2022,Haiti,HTI,Bahamas,BHS,0,0,0,0,0,0,0,0,0,0,0,0,0,0,5
2022,Jamaica,JAM,Bahamas,BHS,0,0,0,0,0,0,0,0,0,0,0,0,0,0,5
2022,South Africa,ZAF,Bahamas,BHS,0,0,0,0,0,0,0,0,0,0,0,0,0,0,5
2022,Uganda,UGA,Bahamas,BHS,0,0,0,0,0,0,0,0,0,0,0,0,0,0,5
2022,Burundi,BDI,Burkina Faso,BFA,0,0,0,8,0,0,8,5,0,0,12,0,0,17,25
2022,Central African Rep.,CAF,Burkina Faso,BFA,6,8,12,44,0,0,70,5,0,8,44,0,0,57,127
2022,Chad,TCD,Burkina Faso,BFA,0,0,5,13,0,0,18,0,0,0,18,10,0,28,46
2022,Congo,COG,Burkina Faso,BFA,0,9,0,0,0,0,9,0,0,0,6,0,0,6,15
2022,Dem. Rep. of the Congo,COD,Burkina Faso,BFA,0,0,0,5,0,0,5,0,0,5,9,0,0,14,19
2022,Cote d'Ivoire,CIV,Burkina Faso,BFA,0,0,0,0,0,0,0,0,0,0,5,0,0,5,5
2022,Mali,MLI,Burkina Faso,BFA,3187,5128,2597,7643,597,0,19152,3149,4797,2573,4348,510,0,15377,34529
2022,Niger,NER,Burkina Faso,BFA,13,14,5,29,0,0,61,17,7,0,22,0,0,46,107
2022,Rwanda,RWA,Burkina Faso,BFA,0,0,7,0,0,0,7,0,0,0,0,0,0,0,7
2022,Syrian Arab Rep.,SYR,Burkina Faso,BFA,0,0,0,0,0,0,0,5,0,0,0,0,0,5,5
2022,Togo,TGO,Burkina Faso,BFA,0,0,0,6,0,0,6,0,0,0,0,0,0,0,6
2022,Türkiye,TUR,Burkina Faso,BFA,0,0,0,14,0,0,14,0,0,6,15,0,0,21,35
2022,Afghanistan,AFG,Belarus,BLR,0,5,6,36,5,0,52,0,26,14,52,8,0,100,152
2022,Armenia,ARM,Belarus,BLR,0,5,0,0,0,0,5,0,0,0,0,0,0,0,5
2022,Azerbaijan,AZE,Belarus,BLR,0,0,0,5,0,0,5,0,0,0,0,0,0,0,5
2022,Cameroon,CMR,Belarus,BLR,5,0,0,0,0,0,5,0,0,0,0,0,0,0,5
2022,Ethiopia,ETH,Belarus,BLR,0,0,0,0,0,0,0,0,0,0,5,0,0,5,5
2022,Palestinian,PSE,Belarus,BLR,0,8,0,0,0,0,8,0,0,0,0,0,0,0,8
2022,United Kingdom of Great Britain and Northern Ireland,GBR,Belarus,BLR,0,0,6,0,0,0,6,0,0,0,0,0,0,0,6
2022,Georgia,GEO,Belarus,BLR,0,0,0,20,5,0,25,0,0,0,18,5,0,23,48
2022,Iran (Islamic Rep. of),IRN,Belarus,BLR,0,0,5,7,0,0,12,0,0,0,0,0,0,0,12
2022,Iraq,IRQ,Belarus,BLR,0,0,0,6,0,0,6,0,14,0,5,0,0,19,25
2022,Libya,LBY,Belarus,BLR,0,0,0,0,0,0,0,0,0,0,7,0,0,7,7
2022,Lebanon,LBN,Belarus,BLR,0,0,0,0,0,0,0,0,0,0,5,0,0,5,5
2022,Latvia,LVA,Belarus,BLR,0,0,0,0,0,0,0,0,0,0,0,0,0,0,13
2022,Russian Federation,RUS,Belarus,BLR,0,0,0,9,0,0,9,0,0,0,0,0,0,0,9
2022,Syrian Arab Rep.,SYR,Belarus,BLR,5,0,0,5,0,0,10,0,0,0,48,0,0,48,66
2022,Tajikistan,TJK,Belarus,BLR,0,0,0,0,0,0,0,0,0,0,10,0,0,10,10
2022,Türkiye,TUR,Belarus,BLR,0,0,5,5,0,0,10,0,5,0,6,0,0,11,26
2022,Ukraine,UKR,Belarus,BLR,73,229,109,926,399,68,1804,99,240,134,686,153,56,1368,19916
2022,Yemen,YEM,Belarus,BLR,0,6,0,0,0,0,6,0,0,0,25,0,0,25,31
2022,Argentina,ARG,Bolivia (Plurinational State of),BOL,0,0,0,0,0,0,0,0,0,0,0,0,0,0,13
2022,Colombia,COL,Bolivia (Plurinational State of),BOL,0,0,0,0,0,0,0,0,0,0,0,0,0,0,247
2022,Cuba,CUB,Bolivia (Plurinational State of),BOL,0,0,0,0,0,0,0,0,0,0,0,0,0,0,48
2022,Ecuador,ECU,Bolivia (Plurinational State of),BOL,0,0,0,0,0,0,0,0,0,0,0,0,0,0,14
2022,Cote d'Ivoire,CIV,Bolivia (Plurinational State of),BOL,0,0,0,0,0,0,0,0,0,0,0,0,0,0,5
2022,Iraq,IRQ,Bolivia (Plurinational State of),BOL,0,0,0,0,0,0,0,0,0,0,0,0,0,0,16
2022,Niger,NER,Bolivia (Plurinational State of),BOL,0,0,0,0,0,0,0,0,0,0,0,0,0,0,5
2022,Pakistan,PAK,Bolivia (Plurinational State of),BOL,0,0,0,0,0,0,0,0,0,0,0,0,0,0,5
2022,Peru,PER,Bolivia (Plurinational State of),BOL,0,0,0,0,0,0,0,0,0,0,0,0,0,0,530
2022,Russian Federation,RUS,Bolivia (Plurinational State of),BOL,0,0,0,0,0,0,0,0,0,0,0,0,0,0,14
2022,Syrian Arab Rep.,SYR,Bolivia (Plurinational State of),BOL,0,0,0,0,0,0,0,0,0,0,0,0,0,0,22
2022,Ukraine,UKR,Bolivia (Plurinational State of),BOL,0,0,0,0,0,0,0,0,0,0,0,0,0,0,5
2022,Uruguay,URY,Bolivia (Plurinational State of),BOL,0,0,0,0,0,0,0,0,0,0,0,0,0,0,10
2022,Venezuela (Bolivarian Republic of),VEN,Bolivia (Plurinational State of),BOL,0,0,0,0,0,0,0,0,0,0,0,0,0,0,13774
2022,Burundi,BDI,Botswana,BWA,6,8,0,6,0,0,20,0,5,0,23,0,0,28,48
2022,Dem. Rep. of the Congo,COD,Botswana,BWA,24,26,22,58,0,0,130,24,37,20,95,0,0,176,391
2022,Namibia,NAM,Botswana,BWA,0,0,0,0,0,0,0,0,0,0,5,0,0,5,5
2022,Rwanda,RWA,Botswana,BWA,0,0,0,0,0,0,0,0,12,0,6,0,0,18,18
2022,Somalia,SOM,Botswana,BWA,21,32,23,71,0,0,147,16,36,22,93,14,0,181,328
2022,South Sudan,SSD,Botswana,BWA,0,0,0,0,0,0,0,0,0,0,5,0,0,5,5
2022,Sudan,SDN,Botswana,BWA,0,0,0,0,0,0,0,0,0,0,5,0,0,5,5
2022,Uganda,UGA,Botswana,BWA,0,0,5,0,0,0,5,0,0,0,10,0,0,10,15
2022,Zimbabwe,ZWE,Botswana,BWA,0,0,0,5,0,0,5,0,0,0,10,0,0,10,15
2022,Afghanistan,AFG,Brazil,BRA,0,0,0,0,0,0,0,0,0,0,0,0,0,0,1042
2022,Albania,ALB,Brazil,BRA,0,0,0,0,0,0,0,0,0,0,0,0,0,0,6
2022,Algeria,DZA,Brazil,BRA,0,0,0,0,0,0,0,0,0,0,0,0,0,0,40
2022,Andorra,AND,Brazil,BRA,0,0,0,0,0,0,0,0,0,0,0,0,0,0,5
2022,Angola,AGO,Brazil,BRA,0,0,0,0,0,0,0,0,0,0,0,0,0,0,9162
2022,Egypt,EGY,Brazil,BRA,0,0,0,0,0,0,0,0,0,0,0,0,0,0,507
2022,Argentina,ARG,Brazil,BRA,0,0,0,0,0,0,0,0,0,0,0,0,0,0,170
2022,Armenia,ARM,Brazil,BRA,0,0,0,0,0,0,0,0,0,0,0,0,0,0,11
2022,Bahrain,BHR,Brazil,BRA,0,0,0,0,0,0,0,0,0,0,0,0,0,0,5
2022,Burundi,BDI,Brazil,BRA,0,0,0,0,0,0,0,0,0,0,0,0,0,0,68
2022,Belgium,BEL,Brazil,BRA,0,0,0,0,0,0,0,0,0,0,0,0,0,0,5
2022,Benin,BEN,Brazil,BRA,0,0,0,0,0,0,0,0,0,0,0,0,0,0,226
2022,Bangladesh,BGD,Brazil,BRA,0,0,0,0,0,0,0,0,0,0,0,0,0,0,4403
2022,Bhutan,BTN,Brazil,BRA,0,0,0,0,0,0,0,0,0,0,0,0,0,0,62
2022,Burkina Faso,BFA,Brazil,BRA,0,0,0,0,0,0,0,0,0,0,0,0,0,0,354
2022,Belarus,BLR,Brazil,BRA,0,0,0,0,0,0,0,0,0,0,0,0,0,0,13
2022,Bolivia (Plurinational State of),BOL,Brazil,BRA,0,0,0,0,0,0,0,0,0,0,0,0,0,0,601
2022,Bosnia and Herzegovina,BIH,Brazil,BRA,0,0,0,0,0,0,0,0,0,0,0,0,0,0,5
2022,Bulgaria,BGR,Brazil,BRA,0,0,0,0,0,0,0,0,0,0,0,0,0,0,6
2022,Cambodia,KHM,Brazil,BRA,0,0,0,0,0,0,0,0,0,0,0,0,0,0,5
2022,Central African Rep.,CAF,Brazil,BRA,0,0,0,0,0,0,0,0,0,0,0,0,0,0,12
2022,China,CHN,Brazil,BRA,0,0,0,0,0,0,0,0,0,0,0,0,0,0,4645
2022,Chile,CHL,Brazil,BRA,0,0,0,0,0,0,0,0,0,0,0,0,0,0,125
2022,Cameroon,CMR,Brazil,BRA,0,0,0,0,0,0,0,0,0,0,0,0,0,0,720
2022,Congo,COG,Brazil,BRA,0,0,0,0,0,0,0,0,0,0,0,0,0,0,154
2022,Dem. Rep. of the Congo,COD,Brazil,BRA,0,0,0,0,0,0,0,0,0,0,0,0,0,0,4077
2022,Colombia,COL,Brazil,BRA,0,0,0,0,0,0,0,0,0,0,0,0,0,0,3684
2022,Costa Rica,CRI,Brazil,BRA,0,0,0,0,0,0,0,0,0,0,0,0,0,0,19
2022,Cuba,CUB,Brazil,BRA,0,0,0,0,0,0,0,0,0,0,0,0,0,0,19778
2022,Cabo Verde,CPV,Brazil,BRA,0,0,0,0,0,0,0,0,0,0,0,0,0,0,179
2022,Cyprus,CYP,Brazil,BRA,0,0,0,0,0,0,0,0,0,0,0,0,0,0,5
2022,Czechia,CZE,Brazil,BRA,0,0,0,0,0,0,0,0,0,0,0,0,0,0,5
2022,Denmark,DNK,Brazil,BRA,0,0,0,0,0,0,0,0,0,0,0,0,0,0,13
2022,Djibouti,DJI,Brazil,BRA,0,0,0,0,0,0,0,0,0,0,0,0,0,0,7
2022,Dominica,DMA,Brazil,BRA,0,0,0,0,0,0,0,0,0,0,0,0,0,0,16
2022,Dominican Rep.,DOM,Brazil,BRA,0,0,0,0,0,0,0,0,0,0,0,0,0,0,1354
2022,Ecuador,ECU,Brazil,BRA,0,0,0,0,0,0,0,0,0,0,0,0,0,0,183
2022,Equatorial Guinea,GNQ,Brazil,BRA,0,0,0,0,0,0,0,0,0,0,0,0,0,0,18
2022,Eritrea,ERI,Brazil,BRA,0,0,0,0,0,0,0,0,0,0,0,0,0,0,88
2022,Ethiopia,ETH,Brazil,BRA,0,0,0,0,0,0,0,0,0,0,0,0,0,0,83
2022,French Guiana,GUF,Brazil,BRA,0,0,0,0,0,0,0,0,0,0,0,0,0,0,17
2022,Fiji,FJI,Brazil,BRA,0,0,0,0,0,0,0,0,0,0,0,0,0,0,20
2022,France,FRA,Brazil,BRA,0,0,0,0,0,0,0,0,0,0,0,0,0,0,54
2022,Gambia,GMB,Brazil,BRA,0,0,0,0,0,0,0,0,0,0,0,0,0,0,288
2022,Palestinian,PSE,Brazil,BRA,0,0,0,0,0,0,0,0,0,0,0,0,0,0,901
2022,United Kingdom of Great Britain and Northern Ireland,GBR,Brazil,BRA,0,0,0,0,0,0,0,0,0,0,0,0,0,0,6
2022,Georgia,GEO,Brazil,BRA,0,0,0,0,0,0,0,0,0,0,0,0,0,0,16
2022,Germany,DEU,Brazil,BRA,0,0,0,0,0,0,0,0,0,0,0,0,0,0,33
2022,Ghana,GHA,Brazil,BRA,0,0,0,0,0,0,0,0,0,0,0,0,0,0,1988
2022,Guinea-Bissau,GNB,Brazil,BRA,0,0,0,0,0,0,0,0,0,0,0,0,0,0,1510
2022,Greece,GRC,Brazil,BRA,0,0,0,0,0,0,0,0,0,0,0,0,0,0,5
2022,Guatemala,GTM,Brazil,BRA,0,0,0,0,0,0,0,0,0,0,0,0,0,0,30
2022,Guinea,GIN,Brazil,BRA,0,0,0,0,0,0,0,0,0,0,0,0,0,0,903
2022,Guyana,GUY,Brazil,BRA,0,0,0,0,0,0,0,0,0,0,0,0,0,0,195
2022,Haiti,HTI,Brazil,BRA,0,0,0,0,0,0,0,0,0,0,0,0,0,0,34582
2022,Honduras,HND,Brazil,BRA,0,0,0,0,0,0,0,0,0,0,0,0,0,0,14
2022,Croatia,HRV,Brazil,BRA,0,0,0,0,0,0,0,0,0,0,0,0,0,0,6
2022,Hungary,HUN,Brazil,BRA,0,0,0,0,0,0,0,0,0,0,0,0,0,0,10
2022,Cote d'Ivoire,CIV,Brazil,BRA,0,0,0,0,0,0,0,0,0,0,0,0,0,0,202
2022,India,IND,Brazil,BRA,0,0,0,0,0,0,0,0,0,0,0,0,0,0,867
2022,Indonesia,IDN,Brazil,BRA,0,0,0,0,0,0,0,0,0,0,0,0,0,0,5
2022,Iran (Islamic Rep. of),IRN,Brazil,BRA,0,0,0,0,0,0,0,0,0,0,0,0,0,0,261
2022,Iraq,IRQ,Brazil,BRA,0,0,0,0,0,0,0,0,0,0,0,0,0,0,728
2022,Israel,ISR,Brazil,BRA,0,0,0,0,0,0,0,0,0,0,0,0,0,0,37
2022,Italy,ITA,Brazil,BRA,0,0,0,0,0,0,0,0,0,0,0,0,0,0,40
2022,Jamaica,JAM,Brazil,BRA,0,0,0,0,0,0,0,0,0,0,0,0,0,0,15
2022,Jordan,JOR,Brazil,BRA,0,0,0,0,0,0,0,0,0,0,0,0,0,0,91
2022,Japan,JPN,Brazil,BRA,0,0,0,0,0,0,0,0,0,0,0,0,0,0,5
2022,Kazakhstan,KAZ,Brazil,BRA,0,0,0,0,0,0,0,0,0,0,0,0,0,0,11
2022,Kenya,KEN,Brazil,BRA,0,0,0,0,0,0,0,0,0,0,0,0,0,0,65
2022,Rep. of Korea,KOR,Brazil,BRA,0,0,0,0,0,0,0,0,0,0,0,0,0,0,254
2022,Kuwait,KWT,Brazil,BRA,0,0,0,0,0,0,0,0,0,0,0,0,0,0,6
2022,Liberia,LBR,Brazil,BRA,0,0,0,0,0,0,0,0,0,0,0,0,0,0,286
2022,Libya,LBY,Brazil,BRA,0,0,0,0,0,0,0,0,0,0,0,0,0,0,63
2022,Lebanon,LBN,Brazil,BRA,0,0,0,0,0,0,0,0,0,0,0,0,0,0,2221
2022,Lesotho,LSO,Brazil,BRA,0,0,0,0,0,0,0,0,0,0,0,0,0,0,5
2022,Sri Lanka,LKA,Brazil,BRA,0,0,0,0,0,0,0,0,0,0,0,0,0,0,78
2022,Lithuania,LTU,Brazil,BRA,0,0,0,0,0,0,0,0,0,0,0,0,0,0,6
2022,Latvia,LVA,Brazil,BRA,0,0,0,0,0,0,0,0,0,0,0,0,0,0,5
2022,"China, Macao SAR",MAC,Brazil,BRA,0,0,0,0,0,0,0,0,0,0,0,0,0,0,28
2022,Mauritania,MRT,Brazil,BRA,0,0,0,0,0,0,0,0,0,0,0,0,0,0,267
2022,North Macedonia,MKD,Brazil,BRA,0,0,0,0,0,0,0,0,0,0,0,0,0,0,6
2022,Mexico,MEX,Brazil,BRA,0,0,0,0,0,0,0,0,0,0,0,0,0,0,55
2022,Mali,MLI,Brazil,BRA,0,0,0,0,0,0,0,0,0,0,0,0,0,0,552
2022,Mongolia,MNG,Brazil,BRA,0,0,0,0,0,0,0,0,0,0,0,0,0,0,5
2022,Morocco,MAR,Brazil,BRA,0,0,0,0,0,0,0,0,0,0,0,0,0,0,929
2022,Mozambique,MOZ,Brazil,BRA,0,0,0,0,0,0,0,0,0,0,0,0,0,0,92
2022,Myanmar,MMR,Brazil,BRA,0,0,0,0,0,0,0,0,0,0,0,0,0,0,10
2022,Namibia,NAM,Brazil,BRA,0,0,0,0,0,0,0,0,0,0,0,0,0,0,24
2022,Nepal,NPL,Brazil,BRA,0,0,0,0,0,0,0,0,0,0,0,0,0,0,304
2022,Netherlands (Kingdom of the),NLD,Brazil,BRA,0,0,0,0,0,0,0,0,0,0,0,0,0,0,6
2022,Niger,NER,Brazil,BRA,0,0,0,0,0,0,0,0,0,0,0,0,0,0,6
2022,Nicaragua,NIC,Brazil,BRA,0,0,0,0,0,0,0,0,0,0,0,0,0,0,43
2022,Nigeria,NGA,Brazil,BRA,0,0,0,0,0,0,0,0,0,0,0,0,0,0,3130
2022,Norway,NOR,Brazil,BRA,0,0,0,0,0,0,0,0,0,0,0,0,0,0,5
2022,New Zealand,NZL,Brazil,BRA,0,0,0,0,0,0,0,0,0,0,0,0,0,0,5
2022,Pakistan,PAK,Brazil,BRA,0,0,0,0,0,0,0,0,0,0,0,0,0,0,1700
2022,Panama,PAN,Brazil,BRA,0,0,0,0,0,0,0,0,0,0,0,0,0,0,7
2022,Paraguay,PRY,Brazil,BRA,0,0,0,0,0,0,0,0,0,0,0,0,0,0,154
2022,Peru,PER,Brazil,BRA,0,0,0,0,0,0,0,0,0,0,0,0,0,0,506
2022,Philippines,PHL,Brazil,BRA,0,0,0,0,0,0,0,0,0,0,0,0,0,0,497
2022,Poland,POL,Brazil,BRA,0,0,0,0,0,0,0,0,0,0,0,0,0,0,16
2022,Portugal,PRT,Brazil,BRA,0,0,0,0,0,0,0,0,0,0,0,0,0,0,116
2022,Romania,ROU,Brazil,BRA,0,0,0,0,0,0,0,0,0,0,0,0,0,0,26
2022,South Africa,ZAF,Brazil,BRA,0,0,0,0,0,0,0,0,0,0,0,0,0,0,223
2022,Russian Federation,RUS,Brazil,BRA,0,0,0,0,0,0,0,0,0,0,0,0,0,0,256
2022,Rwanda,RWA,Brazil,BRA,0,0,0,0,0,0,0,0,0,0,0,0,0,0,27
2022,El Salvador,SLV,Brazil,BRA,0,0,0,0,0,0,0,0,0,0,0,0,0,0,67
2022,Saudi Arabia,SAU,Brazil,BRA,0,0,0,0,0,0,0,0,0,0,0,0,0,0,19
2022,Senegal,SEN,Brazil,BRA,0,0,0,0,0,0,0,0,0,0,0,0,0,0,6273
2022,Sierra Leone,SLE,Brazil,BRA,0,0,0,0,0,0,0,0,0,0,0,0,0,0,426
2022,Somalia,SOM,Brazil,BRA,0,0,0,0,0,0,0,0,0,0,0,0,0,0,420
2022,Spain,ESP,Brazil,BRA,0,0,0,0,0,0,0,0,0,0,0,0,0,0,51
2022,Serbia and Kosovo: S/RES/1244 (1999),SRB,Brazil,BRA,0,0,0,0,0,0,0,0,0,0,0,0,0,0,98
2022,Viet Nam,VNM,Brazil,BRA,0,0,0,0,0,0,0,0,0,0,0,0,0,0,10
2022,Sao Tome and Principe,STP,Brazil,BRA,0,0,0,0,0,0,0,0,0,0,0,0,0,0,18
2022,Sudan,SDN,Brazil,BRA,0,0,0,0,0,0,0,0,0,0,0,0,0,0,190
2022,Suriname,SUR,Brazil,BRA,0,0,0,0,0,0,0,0,0,0,0,0,0,0,30
2022,Slovenia,SVN,Brazil,BRA,0,0,0,0,0,0,0,0,0,0,0,0,0,0,13
2022,Sweden,SWE,Brazil,BRA,0,0,0,0,0,0,0,0,0,0,0,0,0,0,8
2022,Switzerland,CHE,Brazil,BRA,0,0,0,0,0,0,0,0,0,0,0,0,0,0,5
2022,Syrian Arab Rep.,SYR,Brazil,BRA,0,0,0,0,0,0,0,0,0,0,0,0,0,0,7809
2022,United Rep. of Tanzania,TZA,Brazil,BRA,0,0,0,0,0,0,0,0,0,0,0,0,0,0,82
2022,Thailand,THA,Brazil,BRA,0,0,0,0,0,0,0,0,0,0,0,0,0,0,41
2022,Turkmenistan,TKM,Brazil,BRA,0,0,0,0,0,0,0,0,0,0,0,0,0,0,5
2022,Togo,TGO,Brazil,BRA,0,0,0,0,0,0,0,0,0,0,0,0,0,0,583
2022,Trinidad and Tobago,TTO,Brazil,BRA,0,0,0,0,0,0,0,0,0,0,0,0,0,0,13
2022,Tunisia,TUN,Brazil,BRA,0,0,0,0,0,0,0,0,0,0,0,0,0,0,208
2022,Türkiye,TUR,Brazil,BRA,0,0,0,0,0,0,0,0,0,0,0,0,0,0,263
2022,Uganda,UGA,Brazil,BRA,0,0,0,0,0,0,0,0,0,0,0,0,0,0,38
2022,Unknown ,UNK,Brazil,BRA,0,0,0,0,0,0,0,0,0,0,0,0,0,0,45
2022,Ukraine,UKR,Brazil,BRA,0,0,0,0,0,0,0,0,0,0,0,0,0,0,108
2022,Uruguay,URY,Brazil,BRA,0,0,0,0,0,0,0,0,0,0,0,0,0,0,32
2022,United States of America,USA,Brazil,BRA,0,0,0,0,0,0,0,0,0,0,0,0,0,0,56
2022,Vanuatu,VUT,Brazil,BRA,0,0,0,0,0,0,0,0,0,0,0,0,0,0,57
2022,Holy See,VAT,Brazil,BRA,0,0,0,0,0,0,0,0,0,0,0,0,0,0,12
2022,Venezuela (Bolivarian Republic of),VEN,Brazil,BRA,0,0,0,0,0,0,0,0,0,0,0,0,0,0,414502
2022,Yemen,YEM,Brazil,BRA,0,0,0,0,0,0,0,0,0,0,0,0,0,0,137
2022,Zambia,ZMB,Brazil,BRA,0,0,0,0,0,0,0,0,0,0,0,0,0,0,5
2022,Zimbabwe,ZWE,Brazil,BRA,0,0,0,0,0,0,0,0,0,0,0,0,0,0,17
2022,Afghanistan,AFG,Bosnia and Herzegovina,BIH,0,0,0,0,0,0,0,0,0,0,10,0,0,10,10
2022,Azerbaijan,AZE,Bosnia and Herzegovina,BIH,0,0,0,0,0,0,0,0,0,5,0,0,0,5,5
2022,Burundi,BDI,Bosnia and Herzegovina,BIH,0,0,0,0,0,0,0,0,0,0,5,0,0,5,5
2022,Iran (Islamic Rep. of),IRN,Bosnia and Herzegovina,BIH,0,0,0,0,0,0,0,0,0,0,5,0,0,5,5
2022,Iraq,IRQ,Bosnia and Herzegovina,BIH,0,0,0,0,0,0,0,0,0,5,0,0,0,5,5
2022,Pakistan,PAK,Bosnia and Herzegovina,BIH,5,0,0,0,0,0,5,0,0,0,5,0,0,5,10
2022,Russian Federation,RUS,Bosnia and Herzegovina,BIH,0,0,6,0,0,0,6,0,0,0,5,0,0,5,11
2022,Serbia and Kosovo: S/RES/1244 (1999),SRB,Bosnia and Herzegovina,BIH,0,0,5,17,0,0,22,0,0,5,8,0,0,13,35
2022,Syrian Arab Rep.,SYR,Bosnia and Herzegovina,BIH,0,0,0,6,0,0,6,0,12,0,14,0,0,26,32
2022,Türkiye,TUR,Bosnia and Herzegovina,BIH,0,0,12,20,0,0,32,0,12,5,26,0,0,43,75
2022,Ukraine,UKR,Bosnia and Herzegovina,BIH,0,0,0,9,0,0,9,0,0,0,5,0,0,5,147
2022,Afghanistan,AFG,Bulgaria,BGR,0,0,0,0,0,24,24,0,0,0,0,0,3226,3226,3569
2022,Albania,ALB,Bulgaria,BGR,0,0,0,0,0,6,6,0,0,0,0,0,0,0,6
2022,Algeria,DZA,Bulgaria,BGR,0,0,0,0,0,10,10,0,0,0,0,0,44,44,54
2022,Egypt,EGY,Bulgaria,BGR,0,0,0,0,0,0,0,0,0,0,0,0,27,27,44
2022,Armenia,ARM,Bulgaria,BGR,0,0,0,0,0,0,0,0,0,0,0,0,7,7,68
2022,Azerbaijan,AZE,Bulgaria,BGR,0,0,0,0,0,0,0,0,0,0,0,0,0,0,10
2022,Bangladesh,BGD,Bulgaria,BGR,0,0,0,0,0,0,0,0,0,0,0,0,11,11,18
2022,Belarus,BLR,Bulgaria,BGR,0,0,0,0,0,0,0,0,0,0,0,0,5,5,35
2022,Canada,CAN,Bulgaria,BGR,0,0,0,0,0,0,0,0,0,0,0,0,0,0,5
2022,Cameroon,CMR,Bulgaria,BGR,0,0,0,0,0,0,0,0,0,0,0,0,5,5,5
2022,Congo,COG,Bulgaria,BGR,0,0,0,0,0,0,0,0,0,0,0,0,0,0,9
2022,Dem. Rep. of the Congo,COD,Bulgaria,BGR,0,0,0,0,0,5,5,0,0,0,0,0,0,0,5
2022,Dominican Rep.,DOM,Bulgaria,BGR,0,0,0,0,0,5,5,0,0,0,0,0,0,0,5
2022,Eritrea,ERI,Bulgaria,BGR,0,0,0,0,0,0,0,0,0,0,0,0,6,6,19
2022,Ethiopia,ETH,Bulgaria,BGR,0,0,0,0,0,0,0,0,0,0,0,0,0,0,10
2022,United Kingdom of Great Britain and Northern Ireland,GBR,Bulgaria,BGR,0,0,0,0,0,0,0,0,0,0,0,0,0,0,5
2022,Georgia,GEO,Bulgaria,BGR,0,0,0,0,0,0,0,0,0,0,0,0,6,6,36
2022,Guinea,GIN,Bulgaria,BGR,0,0,0,0,0,0,0,0,0,0,0,0,0,0,5
2022,Cote d'Ivoire,CIV,Bulgaria,BGR,0,0,0,0,0,6,6,0,0,0,0,0,0,0,11
2022,India,IND,Bulgaria,BGR,0,0,0,0,0,0,0,0,0,0,0,0,0,0,5
2022,Iran (Islamic Rep. of),IRN,Bulgaria,BGR,0,0,0,0,0,14,14,0,0,0,0,0,70,70,175
2022,Iraq,IRQ,Bulgaria,BGR,0,0,0,0,0,79,79,0,0,0,0,0,491,491,1657
2022,Israel,ISR,Bulgaria,BGR,0,0,0,0,0,0,0,0,0,0,0,0,0,0,25
2022,Jordan,JOR,Bulgaria,BGR,0,0,0,0,0,0,0,0,0,0,0,0,0,0,7
2022,Kazakhstan,KAZ,Bulgaria,BGR,0,0,0,0,0,0,0,0,0,0,0,0,0,0,5
2022,Libya,LBY,Bulgaria,BGR,0,0,0,0,0,0,0,0,0,0,0,0,5,5,5
2022,Lebanon,LBN,Bulgaria,BGR,0,0,0,0,0,0,0,0,0,0,0,0,8,8,30
2022,Mauritania,MRT,Bulgaria,BGR,0,0,0,0,0,0,0,0,0,0,0,0,5,5,5
2022,Rep. of Moldova,MDA,Bulgaria,BGR,0,0,0,0,0,0,0,0,0,0,0,0,0,0,61
2022,Mali,MLI,Bulgaria,BGR,0,0,0,0,0,0,0,0,0,0,0,0,0,0,6
2022,Morocco,MAR,Bulgaria,BGR,0,0,0,0,0,24,24,0,0,0,0,0,976,976,1006
2022,Nigeria,NGA,Bulgaria,BGR,0,0,0,0,0,5,5,0,0,0,0,0,0,0,10
2022,New Zealand,NZL,Bulgaria,BGR,0,0,0,0,0,0,0,0,0,0,0,0,0,0,5
2022,Pakistan,PAK,Bulgaria,BGR,0,0,0,0,0,0,0,0,0,0,0,0,85,85,118
2022,Russian Federation,RUS,Bulgaria,BGR,0,0,0,0,0,51,51,0,0,0,0,0,84,84,424
2022,Somalia,SOM,Bulgaria,BGR,0,0,0,0,0,5,5,0,0,0,0,0,16,16,61
2022,Stateless,XXA,Bulgaria,BGR,0,0,0,0,0,12,12,0,0,0,0,0,53,53,1089
2022,Sudan,SDN,Bulgaria,BGR,0,0,0,0,0,0,0,0,0,0,0,0,0,0,12
2022,Syrian Arab Rep.,SYR,Bulgaria,BGR,0,0,0,0,0,637,637,0,0,0,0,0,5058,5058,29421
2022,Turkmenistan,TKM,Bulgaria,BGR,0,0,0,0,0,0,0,0,0,0,0,0,0,0,36
2022,Tunisia,TUN,Bulgaria,BGR,0,0,0,0,0,0,0,0,0,0,0,0,14,14,19
2022,Türkiye,TUR,Bulgaria,BGR,0,0,0,0,0,6,6,0,0,0,0,0,32,32,50
2022,Ukraine,UKR,Bulgaria,BGR,0,0,0,0,0,100786,100786,0,0,0,0,0,47943,47943,149231
2022,United States of America,USA,Bulgaria,BGR,0,0,0,0,0,0,0,0,0,0,0,0,0,0,20
2022,Uzbekistan,UZB,Bulgaria,BGR,0,0,0,0,0,0,0,0,0,0,0,0,0,0,5
2022,Yemen,YEM,Bulgaria,BGR,0,0,0,0,0,5,5,0,0,0,0,0,21,21,55
2022,Cuba,CUB,Belize,BLZ,0,0,0,0,0,0,0,0,0,0,0,0,0,0,5
2022,Guatemala,GTM,Belize,BLZ,0,0,0,0,0,0,0,0,0,0,0,0,0,0,410
2022,Honduras,HND,Belize,BLZ,0,0,0,0,0,0,0,0,0,0,0,0,0,0,451
2022,Nicaragua,NIC,Belize,BLZ,0,0,0,0,0,0,0,0,0,0,0,0,0,0,7
2022,Peru,PER,Belize,BLZ,0,0,0,0,0,0,0,0,0,0,0,0,0,0,5
2022,El Salvador,SLV,Belize,BLZ,0,0,0,0,0,0,0,0,0,0,0,0,0,0,1249
2022,Myanmar,MMR,Cambodia,KHM,0,7,0,0,0,0,7,0,0,0,8,0,0,8,15
2022,Pakistan,PAK,Cambodia,KHM,0,0,5,0,0,0,5,0,0,0,0,0,0,0,5
2022,Viet Nam,VNM,Cambodia,KHM,0,0,0,6,0,0,6,0,0,0,5,5,0,10,16
2022,Afghanistan,AFG,Canada,CAN,51,79,74,332,80,0,616,45,86,74,600,67,0,872,2016
2022,Albania,ALB,Canada,CAN,0,18,17,110,0,0,145,0,20,14,188,10,0,232,467
2022,Algeria,DZA,Canada,CAN,14,74,56,361,12,0,517,16,68,63,568,13,0,728,1390
2022,Angola,AGO,Canada,CAN,19,116,96,412,5,0,648,26,124,99,476,5,0,730,1769
2022,Antigua and Barbuda,ATG,Canada,CAN,0,0,5,25,0,0,30,0,6,8,18,0,0,32,62
2022,Egypt,EGY,Canada,CAN,18,77,72,292,126,0,585,7,61,87,423,81,0,659,1283
2022,Argentina,ARG,Canada,CAN,6,9,0,22,0,0,37,0,5,12,28,0,0,45,94
2022,Armenia,ARM,Canada,CAN,0,0,0,15,6,0,21,0,0,0,8,5,0,13,39
2022,Australia,AUS,Canada,CAN,0,0,0,0,0,0,0,0,0,0,5,0,0,5,5
2022,Austria,AUT,Canada,CAN,0,5,0,0,0,0,5,0,0,0,0,0,0,0,5
2022,Azerbaijan,AZE,Canada,CAN,0,5,11,51,5,0,72,0,6,8,102,0,0,116,225
2022,Bahrain,BHR,Canada,CAN,0,0,0,5,0,0,5,0,0,0,19,0,0,19,24
2022,Barbados,BRB,Canada,CAN,6,22,30,183,0,0,241,5,19,16,91,0,0,131,418
2022,Burundi,BDI,Canada,CAN,0,25,33,404,72,0,534,5,15,38,408,48,0,514,1127
2022,Belgium,BEL,Canada,CAN,0,0,0,5,0,0,5,0,0,5,0,0,0,5,26
2022,Benin,BEN,Canada,CAN,0,0,0,29,5,0,34,0,0,0,71,0,0,71,116
2022,Bangladesh,BGD,Canada,CAN,9,62,85,540,84,0,780,6,71,111,1023,72,0,1283,2287
2022,Bahamas,BHS,Canada,CAN,44,122,70,494,7,0,737,45,105,62,320,0,0,532,1391
2022,Bhutan,BTN,Canada,CAN,0,0,0,0,0,0,0,0,0,0,5,0,0,5,5
2022,Burkina Faso,BFA,Canada,CAN,0,5,5,67,0,0,77,0,0,5,104,0,0,109,232
2022,Belarus,BLR,Canada,CAN,0,0,5,21,0,0,26,0,0,0,17,0,0,17,43
2022,Bolivia (Plurinational State of),BOL,Canada,CAN,0,8,5,21,0,0,34,0,0,0,22,5,0,27,70
2022,Botswana,BWA,Canada,CAN,0,0,0,13,0,0,13,0,0,0,0,0,0,0,13
2022,Brazil,BRA,Canada,CAN,306,120,13,93,0,0,532,318,108,19,129,0,0,574,1605
2022,Bosnia and Herzegovina,BIH,Canada,CAN,0,0,0,6,0,0,6,0,0,0,0,0,0,0,6
2022,Bulgaria,BGR,Canada,CAN,0,0,7,25,0,0,32,0,14,0,39,0,0,53,93
2022,Belize,BLZ,Canada,CAN,0,0,0,0,0,0,0,0,5,0,0,0,0,5,5
2022,Cambodia,KHM,Canada,CAN,0,0,0,14,5,0,19,0,0,0,16,0,0,16,35
2022,Central African Rep.,CAF,Canada,CAN,0,0,0,27,0,0,27,0,0,0,26,0,0,26,62
2022,Chad,TCD,Canada,CAN,6,33,20,162,5,0,226,5,38,30,449,5,0,527,874
2022,China,CHN,Canada,CAN,10,43,53,1258,143,0,1507,10,52,59,1546,85,0,1752,3457
2022,Chile,CHL,Canada,CAN,436,104,33,208,8,0,789,490,106,26,194,5,0,821,2023
2022,Cameroon,CMR,Canada,CAN,0,21,5,432,84,0,542,5,0,19,424,31,0,479,1204
2022,Congo,COG,Canada,CAN,5,12,12,114,12,0,155,5,7,12,161,0,0,185,446
2022,Dem. Rep. of the Congo,COD,Canada,CAN,36,133,112,1072,142,0,1495,36,121,77,1150,65,0,1449,3366
2022,Comoros,COM,Canada,CAN,0,0,0,0,0,0,0,0,0,0,5,0,0,5,5
2022,Colombia,COL,Canada,CAN,229,672,573,3542,195,0,5211,258,689,516,3424,107,0,4994,13297
2022,Costa Rica,CRI,Canada,CAN,0,0,9,12,0,0,21,8,13,0,18,0,0,39,84
2022,Cuba,CUB,Canada,CAN,8,13,13,236,41,0,311,6,14,10,368,17,0,415,979
2022,Cabo Verde,CPV,Canada,CAN,0,0,0,0,0,0,0,0,0,0,5,0,0,5,5
2022,Cyprus,CYP,Canada,CAN,0,0,0,0,0,0,0,0,0,0,6,0,0,6,6
2022,Czechia,CZE,Canada,CAN,6,16,16,70,10,0,118,5,31,10,97,5,0,148,315
2022,Denmark,DNK,Canada,CAN,0,0,0,0,0,0,0,0,0,0,0,0,0,0,9
2022,Djibouti,DJI,Canada,CAN,0,24,5,77,5,0,111,0,0,10,102,0,0,112,239
2022,Dominica,DMA,Canada,CAN,0,5,0,5,0,0,10,0,0,0,0,0,0,0,10
2022,Dominican Rep.,DOM,Canada,CAN,0,12,6,104,0,0,122,5,12,13,108,0,0,138,314
2022,Ecuador,ECU,Canada,CAN,6,14,10,70,5,0,105,7,12,18,79,0,0,116,274
2022,Equatorial Guinea,GNQ,Canada,CAN,0,0,6,0,0,0,6,0,0,0,0,0,0,0,13
2022,Eritrea,ERI,Canada,CAN,5,16,16,159,57,0,253,5,11,16,335,50,0,417,759
2022,Ethiopia,ETH,Canada,CAN,12,69,49,536,46,0,712,11,67,48,621,23,0,770,1617
2022,Fiji,FJI,Canada,CAN,0,0,0,0,0,0,0,0,5,0,11,0,0,16,23
2022,France,FRA,Canada,CAN,5,10,5,11,0,0,31,6,10,0,11,0,0,27,96
2022,Gabon,GAB,Canada,CAN,0,0,5,22,0,0,27,0,5,0,29,0,0,34,70
2022,Gambia,GMB,Canada,CAN,0,5,0,43,0,0,48,0,0,0,96,0,0,96,165
2022,Palestinian,PSE,Canada,CAN,19,60,60,213,39,0,391,24,66,57,389,41,0,577,997
2022,United Kingdom of Great Britain and Northern Ireland,GBR,Canada,CAN,0,0,5,0,0,0,5,0,6,0,0,0,0,6,65
2022,Georgia,GEO,Canada,CAN,0,0,0,81,11,0,92,0,6,0,269,0,0,275,529
2022,Germany,DEU,Canada,CAN,0,0,7,10,0,0,17,0,7,0,0,0,0,7,47
2022,Ghana,GHA,Canada,CAN,5,22,7,148,5,0,187,6,6,5,358,10,0,385,809
2022,Guinea-Bissau,GNB,Canada,CAN,0,0,0,0,0,0,0,0,0,0,13,0,0,13,18
2022,Greece,GRC,Canada,CAN,0,0,0,11,0,0,11,0,5,0,6,0,0,11,31
2022,Grenada,GRD,Canada,CAN,0,0,0,7,0,0,7,0,0,0,11,0,0,11,18
2022,Guatemala,GTM,Canada,CAN,5,16,7,118,0,0,146,0,5,21,323,0,0,349,522
2022,Guinea,GIN,Canada,CAN,0,15,28,208,12,0,263,0,15,17,230,5,0,267,618
2022,Guyana,GUY,Canada,CAN,5,0,5,38,0,0,48,6,0,6,23,0,0,35,106
2022,Haiti,HTI,Canada,CAN,71,253,262,4656,278,0,5520,79,279,215,4877,100,0,5550,14798
2022,"China, Hong Kong SAR",HKG,Canada,CAN,0,11,10,41,0,0,62,0,0,24,54,0,0,78,165
2022,Honduras,HND,Canada,CAN,11,55,38,201,5,0,310,9,48,32,247,15,0,351,736
2022,Croatia,HRV,Canada,CAN,0,0,5,20,0,0,25,0,0,0,16,0,0,16,41
2022,Hungary,HUN,Canada,CAN,30,110,94,614,62,0,910,24,103,106,642,39,0,914,2413
2022,Iceland,ISL,Canada,CAN,0,0,0,0,0,0,0,0,0,0,8,0,0,8,8
2022,Cote d'Ivoire,CIV,Canada,CAN,0,17,0,149,5,0,171,0,7,7,135,5,0,154,379
2022,India,IND,Canada,CAN,59,406,264,3781,164,0,4674,96,524,384,6527,238,0,7769,13878
2022,Indonesia,IDN,Canada,CAN,0,0,11,22,0,0,33,0,10,0,47,0,0,57,100
2022,Ireland,IRL,Canada,CAN,0,5,0,11,0,0,16,0,5,0,5,0,0,10,32
2022,Iran (Islamic Rep. of),IRN,Canada,CAN,61,289,345,3768,506,0,4969,49,338,370,3333,326,0,4416,9790
2022,Iraq,IRQ,Canada,CAN,5,29,24,158,96,0,312,0,37,34,305,71,0,447,818
2022,Israel,ISR,Canada,CAN,5,11,0,25,0,0,41,6,8,0,33,0,0,47,109
2022,Italy,ITA,Canada,CAN,5,11,10,37,0,0,63,8,12,15,20,5,0,60,134
2022,Jamaica,JAM,Canada,CAN,5,16,14,291,7,0,333,0,17,13,311,0,0,341,812
2022,Jordan,JOR,Canada,CAN,19,52,60,262,20,0,413,13,59,68,685,15,0,840,1342
2022,Japan,JPN,Canada,CAN,0,6,0,0,0,0,6,0,0,0,0,0,0,0,11
2022,Kazakhstan,KAZ,Canada,CAN,0,0,0,32,5,0,37,0,5,0,31,0,0,36,81
2022,Kenya,KEN,Canada,CAN,0,18,9,395,7,0,429,0,8,6,324,10,0,348,884
2022,Kyrgyzstan,KGZ,Canada,CAN,0,0,0,0,0,0,0,0,0,0,14,0,0,14,14
2022,Rep. of Korea,KOR,Canada,CAN,0,0,0,14,0,0,14,0,0,0,13,0,0,13,36
2022,Dem. People's Rep. of Korea,PRK,Canada,CAN,0,0,5,13,0,0,18,0,0,5,10,0,0,15,49
2022,Kuwait,KWT,Canada,CAN,0,5,5,5,0,0,15,0,0,0,23,0,0,23,43
2022,Liberia,LBR,Canada,CAN,0,0,5,52,0,0,57,0,0,5,106,0,0,111,200
2022,Libya,LBY,Canada,CAN,5,35,24,105,5,0,174,9,31,18,263,5,0,326,519
2022,Saint Lucia,LCA,Canada,CAN,0,5,0,27,0,0,32,0,0,0,32,0,0,32,76
2022,Lebanon,LBN,Canada,CAN,15,74,59,450,110,0,708,16,74,103,492,90,0,775,1568
2022,Sri Lanka,LKA,Canada,CAN,13,40,62,402,144,0,661,13,58,52,1547,86,0,1756,2797
2022,Lithuania,LTU,Canada,CAN,0,0,0,5,0,0,5,0,0,0,5,0,0,5,10
2022,Latvia,LVA,Canada,CAN,0,0,0,5,0,0,5,0,0,0,10,0,0,10,15
2022,Madagascar,MDG,Canada,CAN,0,0,0,18,0,0,18,0,0,0,15,0,0,15,33
2022,Mauritania,MRT,Canada,CAN,0,16,0,59,0,0,75,0,14,8,149,6,0,177,270
2022,North Macedonia,MKD,Canada,CAN,0,0,0,5,0,0,5,0,0,0,0,0,0,0,11
2022,Rep. of Moldova,MDA,Canada,CAN,0,0,5,9,0,0,14,0,0,0,7,0,0,7,21
2022,Mexico,MEX,Canada,CAN,311,686,485,4670,65,0,6217,341,693,475,6560,67,0,8136,23916
2022,Mali,MLI,Canada,CAN,0,0,10,71,0,0,81,0,5,5,148,10,0,168,281
2022,Malaysia,MYS,Canada,CAN,0,0,5,19,0,0,24,0,0,0,13,0,0,13,46
2022,Malawi,MWI,Canada,CAN,0,5,0,53,0,0,58,0,0,5,30,0,0,35,101
2022,Montenegro,MNE,Canada,CAN,0,0,0,0,0,0,0,0,0,0,0,0,0,0,8
2022,Mongolia,MNG,Canada,CAN,0,8,6,29,0,0,43,0,5,0,32,0,0,37,92
2022,Morocco,MAR,Canada,CAN,0,14,5,108,7,0,134,5,11,12,73,5,0,106,279
2022,Mozambique,MOZ,Canada,CAN,0,0,7,0,0,0,7,0,0,0,0,0,0,0,12
2022,Malta,MLT,Canada,CAN,0,0,0,0,0,0,0,0,0,0,0,0,0,0,5
2022,Mauritius,MUS,Canada,CAN,0,0,0,18,0,0,18,0,0,0,9,0,0,9,27
2022,Myanmar,MMR,Canada,CAN,0,0,5,40,5,0,50,0,0,0,35,10,0,45,95
2022,Namibia,NAM,Canada,CAN,0,0,5,29,0,0,34,0,5,0,12,0,0,17,103
2022,Nepal,NPL,Canada,CAN,0,0,14,109,5,0,128,0,0,14,217,5,0,236,434
2022,Netherlands (Kingdom of the),NLD,Canada,CAN,0,0,6,10,0,0,16,0,5,0,5,0,0,10,50
2022,Niger,NER,Canada,CAN,0,5,0,28,0,0,33,0,0,5,46,0,0,51,90
2022,Nicaragua,NIC,Canada,CAN,8,41,40,300,5,0,394,14,71,31,373,5,0,494,1153
2022,Nigeria,NGA,Canada,CAN,43,422,343,2014,124,0,2946,40,402,315,2067,74,0,2898,6930
2022,Norway,NOR,Canada,CAN,0,0,0,0,0,0,0,0,0,0,5,0,0,5,10
2022,Oman,OMN,Canada,CAN,0,5,0,0,0,0,5,0,0,8,0,0,0,8,13
2022,Pakistan,PAK,Canada,CAN,79,253,211,1074,232,0,1849,66,214,236,1906,214,0,2636,5436
2022,Panama,PAN,Canada,CAN,5,5,0,6,0,0,16,9,0,0,12,0,0,21,58
2022,Paraguay,PRY,Canada,CAN,0,0,7,0,0,0,7,0,0,8,0,0,0,8,15
2022,Peru,PER,Canada,CAN,25,44,49,264,17,0,399,15,59,43,239,11,0,367,1298
2022,Philippines,PHL,Canada,CAN,0,5,0,68,6,0,79,0,6,0,66,5,0,77,210
2022,Papua New Guinea,PNG,Canada,CAN,0,0,0,0,0,0,0,0,0,0,0,0,0,0,6
2022,Poland,POL,Canada,CAN,5,11,14,66,12,0,108,0,10,12,61,6,0,89,206
2022,Portugal,PRT,Canada,CAN,0,6,10,13,0,0,29,0,6,0,6,0,0,12,71
2022,Qatar,QAT,Canada,CAN,0,0,0,0,0,0,0,0,0,0,0,0,0,0,10
2022,Romania,ROU,Canada,CAN,28,62,55,369,5,0,519,36,79,50,414,10,0,589,1628
2022,South Africa,ZAF,Canada,CAN,5,39,16,89,0,0,149,9,20,16,33,0,0,78,321
2022,Russian Federation,RUS,Canada,CAN,9,19,5,99,17,0,149,0,15,12,147,10,0,184,446
2022,Rwanda,RWA,Canada,CAN,6,20,34,499,31,0,590,5,22,29,532,10,0,598,1266
2022,El Salvador,SLV,Canada,CAN,8,41,57,310,23,0,439,9,67,41,373,14,0,504,999
2022,Saudi Arabia,SAU,Canada,CAN,5,11,10,102,0,0,128,5,11,10,145,0,0,171,336
2022,Senegal,SEN,Canada,CAN,0,0,5,94,0,0,99,0,12,5,243,0,0,260,506
2022,Singapore,SGP,Canada,CAN,0,0,5,0,0,0,5,0,0,0,0,0,0,0,5
2022,Sierra Leone,SLE,Canada,CAN,0,5,10,35,0,0,50,0,5,0,42,0,0,47,121
2022,Somalia,SOM,Canada,CAN,5,14,28,210,29,0,286,0,18,25,482,28,0,553,934
2022,Spain,ESP,Canada,CAN,0,6,5,5,0,0,16,0,6,5,13,0,0,24,77
2022,Serbia and Kosovo: S/RES/1244 (1999),SRB,Canada,CAN,7,0,8,35,0,0,50,0,0,5,29,5,0,39,104
2022,Viet Nam,VNM,Canada,CAN,0,5,12,138,5,0,160,0,5,12,136,5,0,158,347
2022,South Sudan,SSD,Canada,CAN,0,5,0,13,0,0,18,0,0,0,13,0,0,13,36
2022,Stateless,XXA,Canada,CAN,6,40,25,137,29,0,237,5,23,39,202,19,0,288,759
2022,Saint Kitts and Nevis,KNA,Canada,CAN,0,0,0,5,0,0,5,0,0,5,5,0,0,10,15
2022,Sudan,SDN,Canada,CAN,22,57,59,252,10,0,400,29,69,64,318,39,0,519,1147
2022,Suriname,SUR,Canada,CAN,0,0,0,0,0,0,0,0,0,0,5,0,0,5,10
2022,Slovakia,SVK,Canada,CAN,13,29,33,147,9,0,231,16,35,27,179,7,0,264,533
2022,Slovenia,SVN,Canada,CAN,0,0,0,0,0,0,0,0,0,0,0,0,0,0,5
2022,Eswatini,SWZ,Canada,CAN,0,0,0,5,0,0,5,0,0,0,5,0,0,5,21
2022,Sweden,SWE,Canada,CAN,0,5,0,7,0,0,12,0,0,0,5,0,0,5,24
2022,Syrian Arab Rep.,SYR,Canada,CAN,7,27,28,199,145,0,406,14,34,35,319,87,0,489,1012
2022,United Rep. of Tanzania,TZA,Canada,CAN,0,5,6,137,0,0,148,0,5,5,139,5,0,154,352
2022,Thailand,THA,Canada,CAN,0,0,5,0,0,0,5,0,0,0,13,0,0,13,28
2022,Tajikistan,TJK,Canada,CAN,0,0,7,8,0,0,15,0,5,0,15,0,0,20,42
2022,Turkmenistan,TKM,Canada,CAN,0,0,0,7,0,0,7,0,0,0,0,0,0,0,7
2022,Togo,TGO,Canada,CAN,0,0,0,51,0,0,51,0,5,0,110,0,0,115,184
2022,Trinidad and Tobago,TTO,Canada,CAN,0,6,9,30,0,0,45,0,9,5,36,0,0,50,125
2022,Tunisia,TUN,Canada,CAN,0,6,12,67,0,0,85,5,10,5,114,0,0,134,240
2022,Türkiye,TUR,Canada,CAN,147,262,142,1318,32,0,1901,174,293,258,4974,26,0,5725,11278
2022,United Arab Emirates,ARE,Canada,CAN,0,0,8,0,0,0,8,0,8,0,9,0,0,17,50
2022,Uganda,UGA,Canada,CAN,0,20,27,556,10,0,613,0,17,19,550,5,0,591,1385
2022,Unknown ,UNK,Canada,CAN,42,85,62,1029,112,0,1330,37,98,69,1590,83,0,1877,5325
2022,Ukraine,UKR,Canada,CAN,5,18,1395,37907,5276,0,44601,11,14,1554,26743,2217,0,30539,75294
2022,Uruguay,URY,Canada,CAN,0,0,0,8,0,0,8,5,0,6,7,0,0,18,26
2022,United States of America,USA,Canada,CAN,296,174,42,35,0,0,547,332,195,33,40,0,0,600,1632
2022,Uzbekistan,UZB,Canada,CAN,0,0,5,5,5,0,15,0,0,0,30,0,0,30,76
2022,Saint Vincent and the Grenadines,VCT,Canada,CAN,0,0,0,43,5,0,48,0,0,0,32,0,0,32,93
2022,Venezuela (Bolivarian Republic of),VEN,Canada,CAN,12,106,83,750,359,0,1310,16,100,102,792,188,0,1198,3601
2022,Western Sahara,ESH,Canada,CAN,0,0,0,0,0,0,0,0,0,0,5,0,0,5,5
2022,Yemen,YEM,Canada,CAN,5,27,11,134,11,0,188,5,22,27,520,12,0,586,902
2022,Zambia,ZMB,Canada,CAN,0,0,0,25,0,0,25,0,5,0,18,0,0,23,48
2022,Zimbabwe,ZWE,Canada,CAN,8,18,13,263,11,0,313,5,15,13,252,5,0,290,871
2022,Angola,AGO,Central African Rep.,CAF,0,0,6,0,0,0,6,0,0,0,7,0,0,7,13
2022,Burundi,BDI,Central African Rep.,CAF,0,5,0,5,0,0,10,0,0,5,9,0,0,14,24
2022,Chad,TCD,Central African Rep.,CAF,80,201,114,299,26,0,720,80,164,96,382,31,0,753,1473
2022,Cameroon,CMR,Central African Rep.,CAF,0,8,0,23,0,0,31,5,6,0,47,0,0,58,89
2022,Congo,COG,Central African Rep.,CAF,0,9,5,5,0,0,19,0,0,0,5,0,0,5,24
2022,Dem. Rep. of the Congo,COD,Central African Rep.,CAF,556,794,459,1538,117,0,3464,604,811,459,1174,107,0,3155,6619
2022,Guinea,GIN,Central African Rep.,CAF,0,0,0,0,0,0,0,0,0,6,0,0,0,6,6
2022,Cote d'Ivoire,CIV,Central African Rep.,CAF,0,0,0,0,0,0,0,0,0,0,8,0,0,8,8
2022,Liberia,LBR,Central African Rep.,CAF,0,0,0,0,0,0,0,0,0,0,6,0,0,6,6
2022,Rwanda,RWA,Central African Rep.,CAF,5,19,26,44,0,0,94,10,34,11,80,0,0,135,229
2022,Somalia,SOM,Central African Rep.,CAF,0,0,0,0,0,0,0,0,0,0,5,0,0,5,5
2022,South Sudan,SSD,Central African Rep.,CAF,235,374,139,619,49,0,1416,208,355,163,471,52,0,1249,2665
2022,Sudan,SDN,Central African Rep.,CAF,34,67,34,103,0,0,238,27,70,45,111,10,0,263,501
2022,Türkiye,TUR,Central African Rep.,CAF,0,0,0,0,0,0,0,0,0,0,9,0,0,9,9
2022,Uganda,UGA,Central African Rep.,CAF,0,0,0,7,0,0,7,0,0,0,5,0,0,5,12
2022,Cuba,CUB,Cayman Islands,CYM,0,0,0,0,0,0,0,0,0,0,0,0,0,0,289
2022,Burundi,BDI,Chad,TCD,0,0,6,0,0,0,6,0,0,0,0,0,0,0,6
2022,Benin,BEN,Chad,TCD,0,5,0,0,0,0,5,0,0,0,0,0,0,0,5
2022,Central African Rep.,CAF,Chad,TCD,8466,16175,10583,30509,2506,0,68239,8484,16237,10361,21864,1723,0,58669,126908
2022,Cameroon,CMR,Chad,TCD,2309,3125,1485,4370,466,12179,23934,2333,2856,1250,2062,207,10001,18709,42643
2022,Congo,COG,Chad,TCD,0,0,6,0,0,0,6,0,0,0,10,0,0,10,16
2022,Dem. Rep. of the Congo,COD,Chad,TCD,13,30,27,51,5,0,126,11,34,18,96,10,0,169,295
2022,Eritrea,ERI,Chad,TCD,0,0,0,10,0,0,10,0,0,0,23,0,0,23,33
2022,Ethiopia,ETH,Chad,TCD,5,0,0,21,0,0,26,0,0,0,13,0,0,13,39
2022,Palestinian,PSE,Chad,TCD,0,0,0,0,0,0,0,0,0,0,6,0,0,6,6
2022,Cote d'Ivoire,CIV,Chad,TCD,0,0,0,0,0,0,0,0,0,0,5,0,0,5,5
2022,Iran (Islamic Rep. of),IRN,Chad,TCD,0,0,0,0,0,0,0,0,0,0,5,0,0,5,5
2022,Libya,LBY,Chad,TCD,0,6,7,10,0,0,23,0,8,0,17,0,0,25,48
2022,Mali,MLI,Chad,TCD,0,0,0,0,0,0,0,0,7,0,0,0,0,7,7
2022,Niger,NER,Chad,TCD,55,113,66,163,20,0,417,71,123,69,165,21,0,449,866
2022,Nigeria,NGA,Chad,TCD,1953,2631,1603,4322,203,0,10712,1753,2732,1450,3697,457,0,10089,20801
2022,Rwanda,RWA,Chad,TCD,0,0,0,5,0,0,5,0,0,0,9,0,0,9,14
2022,Somalia,SOM,Chad,TCD,0,0,0,0,0,0,0,0,0,0,7,0,0,7,7
2022,South Sudan,SSD,Chad,TCD,0,8,0,0,0,0,8,0,9,0,8,0,0,17,25
2022,Sudan,SDN,Chad,TCD,30515,42121,31259,104006,10220,6530,224651,31248,42681,30683,64647,6622,5364,181245,405896
2022,Syrian Arab Rep.,SYR,Chad,TCD,5,7,0,15,0,0,27,7,6,6,31,0,0,50,77
2022,Yemen,YEM,Chad,TCD,0,0,0,5,0,0,5,0,0,0,10,0,0,10,15
2022,Afghanistan,AFG,China,CHN,0,18,0,16,0,0,34,0,7,0,26,0,0,33,67
2022,Belarus,BLR,China,CHN,0,0,0,5,0,0,5,0,0,0,0,0,0,0,5
2022,Cameroon,CMR,China,CHN,21,6,0,118,0,0,145,14,10,0,166,0,0,190,335
2022,Congo,COG,China,CHN,0,0,0,0,0,0,0,0,0,0,5,0,0,5,5
2022,Dem. Rep. of the Congo,COD,China,CHN,0,9,5,5,0,0,19,0,6,0,0,0,0,6,25
2022,Eritrea,ERI,China,CHN,0,0,0,0,0,0,0,6,0,0,0,0,0,6,6
2022,Ethiopia,ETH,China,CHN,0,0,0,0,0,0,0,0,0,0,15,0,0,15,15
2022,Palestinian,PSE,China,CHN,5,0,0,0,0,0,5,0,6,0,5,0,0,11,16
2022,Ghana,GHA,China,CHN,0,0,0,8,0,0,8,5,0,0,15,0,0,20,28
2022,Guinea,GIN,China,CHN,0,0,0,0,0,0,0,0,0,0,5,0,0,5,5
2022,Cote d'Ivoire,CIV,China,CHN,0,0,0,0,0,0,0,0,0,0,22,0,0,22,22
2022,Iran (Islamic Rep. of),IRN,China,CHN,0,0,0,0,0,0,0,0,0,5,0,0,0,5,5
2022,Iraq,IRQ,China,CHN,0,0,0,0,0,0,0,0,0,8,6,0,0,14,14
2022,Kenya,KEN,China,CHN,0,0,0,6,0,0,6,0,0,0,5,0,0,5,11
2022,Liberia,LBR,China,CHN,0,0,0,0,0,0,0,0,0,0,6,0,0,6,6
2022,Nigeria,NGA,China,CHN,0,0,0,5,0,0,5,0,0,0,62,0,0,62,67
2022,Pakistan,PAK,China,CHN,0,8,0,8,0,0,16,0,0,6,14,0,0,20,36
2022,Russian Federation,RUS,China,CHN,0,0,0,19,0,0,19,0,0,0,5,0,0,5,24
2022,Rwanda,RWA,China,CHN,0,0,0,9,0,0,9,0,0,0,0,0,0,0,9
2022,Somalia,SOM,China,CHN,11,8,0,27,0,0,46,16,0,6,27,0,0,49,95
2022,Syrian Arab Rep.,SYR,China,CHN,0,9,5,7,0,0,21,0,0,7,16,0,0,23,44
2022,Uganda,UGA,China,CHN,0,0,0,61,0,0,61,0,5,0,40,0,0,45,106
2022,Ukraine,UKR,China,CHN,0,0,0,6,0,0,6,0,0,0,12,0,0,12,18
2022,Uzbekistan,UZB,China,CHN,0,0,0,0,0,0,0,0,0,0,5,0,0,5,5
2022,Yemen,YEM,China,CHN,0,5,6,0,0,0,11,0,12,0,20,0,0,32,43
2022,Zambia,ZMB,China,CHN,0,0,0,0,0,0,0,0,0,0,5,0,0,5,5
2022,Zimbabwe,ZWE,China,CHN,0,0,0,68,0,0,68,0,0,0,20,0,0,20,88
2022,Afghanistan,AFG,Chile,CHL,5,13,6,99,6,0,129,5,11,6,90,5,0,117,246
2022,Angola,AGO,Chile,CHL,0,0,0,5,0,0,5,0,0,0,0,0,0,0,5
2022,Bangladesh,BGD,Chile,CHL,0,0,0,7,0,0,7,0,0,0,0,0,0,0,7
2022,Bolivia (Plurinational State of),BOL,Chile,CHL,0,0,0,11,0,0,11,0,0,0,10,0,0,10,21
2022,Congo,COG,Chile,CHL,0,5,0,8,0,0,13,0,0,0,0,0,0,0,13
2022,Dem. Rep. of the Congo,COD,Chile,CHL,0,0,0,5,0,0,5,0,0,0,0,0,0,0,5
2022,Colombia,COL,Chile,CHL,78,218,104,1485,95,0,1980,58,203,113,1389,46,0,1809,3789
2022,Costa Rica,CRI,Chile,CHL,0,5,0,0,0,0,5,0,0,0,0,0,0,0,5
2022,Cuba,CUB,Chile,CHL,15,41,20,290,18,0,384,11,39,22,272,9,0,353,737
2022,Dominican Rep.,DOM,Chile,CHL,0,5,5,41,0,0,51,0,9,0,35,0,0,44,95
2022,Ecuador,ECU,Chile,CHL,0,5,0,22,0,0,27,0,5,0,20,0,0,25,52
2022,Palestinian,PSE,Chile,CHL,0,0,0,13,0,0,13,0,0,0,8,0,0,8,21
2022,Ghana,GHA,Chile,CHL,0,0,0,8,0,0,8,0,0,0,0,0,0,0,8
2022,Guatemala,GTM,Chile,CHL,0,5,0,0,0,0,5,0,0,0,0,0,0,0,5
2022,Haiti,HTI,Chile,CHL,5,11,6,79,5,0,106,5,10,5,76,0,0,96,202
2022,Honduras,HND,Chile,CHL,0,5,0,0,0,0,5,0,0,0,0,0,0,0,5
2022,Iraq,IRQ,Chile,CHL,0,0,0,7,0,0,7,0,0,0,7,0,0,7,14
2022,Kenya,KEN,Chile,CHL,0,5,0,0,0,0,5,0,0,0,0,0,0,0,5
2022,Rep. of Korea,KOR,Chile,CHL,0,0,0,5,0,0,5,0,0,0,0,0,0,0,5
2022,Sri Lanka,LKA,Chile,CHL,0,0,0,5,0,0,5,0,0,0,0,0,0,0,5
2022,Nicaragua,NIC,Chile,CHL,0,5,0,0,0,0,5,0,0,0,0,0,0,0,5
2022,Pakistan,PAK,Chile,CHL,0,0,0,7,0,0,7,0,0,0,0,0,0,0,7
2022,Peru,PER,Chile,CHL,0,12,5,63,5,0,85,0,12,5,62,0,0,79,164
2022,Russian Federation,RUS,Chile,CHL,0,13,0,31,0,0,44,0,7,0,28,0,0,35,79
2022,El Salvador,SLV,Chile,CHL,0,5,0,19,0,0,24,0,0,0,12,0,0,12,36
2022,Senegal,SEN,Chile,CHL,0,5,0,0,0,0,5,0,0,0,0,0,0,0,5
2022,Sierra Leone,SLE,Chile,CHL,0,5,0,0,0,0,5,0,0,0,0,0,0,0,5
2022,Syrian Arab Rep.,SYR,Chile,CHL,0,12,5,54,5,0,76,0,11,5,52,0,0,68,144
2022,Türkiye,TUR,Chile,CHL,0,10,0,10,0,0,20,0,0,0,12,0,0,12,32
2022,Unknown ,UNK,Chile,CHL,14,35,17,245,16,0,327,12,32,18,231,5,0,298,625
2022,Ukraine,UKR,Chile,CHL,0,11,0,40,0,0,51,0,11,0,37,0,0,48,99
2022,United States of America,USA,Chile,CHL,0,5,0,0,0,0,5,0,0,0,0,0,0,0,5
2022,Venezuela (Bolivarian Republic of),VEN,Chile,CHL,155,438,207,2970,189,228168,232127,116,411,224,2775,93,208677,212296,444423
2022,Angola,AGO,Cameroon,CMR,0,0,5,0,0,0,5,0,0,0,0,0,0,0,5
2022,Burundi,BDI,Cameroon,CMR,6,7,5,19,0,0,37,0,5,15,19,0,0,39,76
2022,Burkina Faso,BFA,Cameroon,CMR,0,0,0,5,0,0,5,0,0,0,20,0,0,20,25
2022,Central African Rep.,CAF,Cameroon,CMR,24026,42129,26343,81952,5815,0,180265,24648,42799,25463,64858,6223,0,163991,352733
2022,Chad,TCD,Cameroon,CMR,70,198,140,542,5,0,955,75,207,164,1005,50,0,1501,2456
2022,Congo,COG,Cameroon,CMR,0,0,0,23,0,0,23,9,5,5,21,0,0,40,63
2022,Dem. Rep. of the Congo,COD,Cameroon,CMR,21,50,45,168,10,0,294,20,62,38,191,21,0,332,626
2022,Equatorial Guinea,GNQ,Cameroon,CMR,0,0,12,0,0,0,12,0,0,0,0,0,0,0,12
2022,Gabon,GAB,Cameroon,CMR,0,0,0,0,0,0,0,0,0,0,5,0,0,5,5
2022,Guinea,GIN,Cameroon,CMR,7,10,8,29,0,0,54,10,12,0,143,0,0,165,219
2022,Cote d'Ivoire,CIV,Cameroon,CMR,9,0,0,12,0,0,21,10,0,0,55,0,0,65,86
2022,Iran (Islamic Rep. of),IRN,Cameroon,CMR,0,0,0,0,0,0,0,0,5,0,0,0,0,5,5
2022,Iraq,IRQ,Cameroon,CMR,0,6,0,0,0,0,6,0,0,0,0,0,0,0,6
2022,Liberia,LBR,Cameroon,CMR,5,0,0,0,0,0,5,0,0,0,9,0,0,9,14
2022,Mauritania,MRT,Cameroon,CMR,0,0,0,0,0,0,0,0,0,0,10,0,0,10,10
2022,Mali,MLI,Cameroon,CMR,6,15,10,50,0,0,81,12,18,15,247,9,0,301,382
2022,Morocco,MAR,Cameroon,CMR,0,7,0,0,0,0,7,0,0,0,0,0,0,0,7
2022,Niger,NER,Cameroon,CMR,16,10,6,93,0,0,125,21,15,7,924,17,0,984,1109
2022,Nigeria,NGA,Cameroon,CMR,11225,17035,9428,26546,2817,0,67051,10969,16938,9124,17951,2649,0,57631,124682
2022,Rwanda,RWA,Cameroon,CMR,13,40,19,116,8,0,196,12,31,26,146,11,0,226,422
2022,Senegal,SEN,Cameroon,CMR,0,0,0,0,0,0,0,0,0,0,7,0,0,7,7
2022,Sierra Leone,SLE,Cameroon,CMR,0,5,0,0,0,0,5,0,0,0,0,0,0,0,5
2022,South Sudan,SSD,Cameroon,CMR,0,0,0,0,0,0,0,0,0,0,12,0,0,12,12
2022,Sudan,SDN,Cameroon,CMR,0,12,12,16,0,0,40,5,14,0,46,0,0,65,105
2022,Syrian Arab Rep.,SYR,Cameroon,CMR,0,0,5,5,0,0,10,0,0,0,5,0,0,5,15
2022,Togo,TGO,Cameroon,CMR,0,12,0,5,0,0,17,0,5,6,9,0,0,20,37
2022,Türkiye,TUR,Cameroon,CMR,0,5,0,0,0,0,5,0,0,0,0,0,0,0,5
2022,Yemen,YEM,Cameroon,CMR,0,0,0,0,0,0,0,0,0,0,5,0,0,5,5
2022,Angola,AGO,Congo,COG,0,5,0,15,0,0,20,0,0,0,32,8,0,40,60
2022,Burundi,BDI,Congo,COG,0,0,5,31,0,0,36,0,5,5,40,0,0,50,86
2022,Central African Rep.,CAF,Congo,COG,1516,3267,2143,7733,339,0,14998,1466,3189,1983,7710,294,0,14642,29640
2022,Chad,TCD,Congo,COG,0,5,0,7,0,0,12,0,0,6,33,5,0,44,56
2022,Cameroon,CMR,Congo,COG,0,0,0,5,0,0,5,0,0,0,26,0,0,26,31
2022,Dem. Rep. of the Congo,COD,Congo,COG,992,2534,2386,6712,703,0,13327,794,2395,2416,7177,716,0,13498,26825
2022,Guinea,GIN,Congo,COG,0,0,0,0,0,0,0,0,0,0,5,0,0,5,5
2022,Cote d'Ivoire,CIV,Congo,COG,0,0,0,0,0,0,0,0,0,5,5,0,0,10,10
2022,Mauritania,MRT,Congo,COG,0,0,0,0,0,0,0,0,0,0,50,0,0,50,50
2022,Nigeria,NGA,Congo,COG,0,0,0,0,0,0,0,0,0,0,5,0,0,5,5
2022,Rwanda,RWA,Congo,COG,16,194,268,937,35,0,1450,26,151,266,1062,93,0,1598,3048
2022,Sudan,SDN,Congo,COG,0,0,5,10,0,0,15,0,0,10,54,0,0,64,79
2022,Syrian Arab Rep.,SYR,Congo,COG,0,9,0,9,0,0,18,0,0,0,0,0,0,0,18
2022,Angola,AGO,Dem. Rep. of the Congo,COD,14,39,27,82,15,0,177,10,34,41,86,40,0,211,388
2022,Burundi,BDI,Dem. Rep. of the Congo,COD,4052,6025,3502,8956,465,0,23000,4058,6018,3648,7932,463,0,22119,45119
2022,Central African Rep.,CAF,Dem. Rep. of the Congo,COD,12113,31214,18362,47802,3683,0,113174,11797,30611,17953,34920,2725,0,98006,211180
2022,Chad,TCD,Dem. Rep. of the Congo,COD,6,9,0,0,0,0,15,0,7,0,5,0,0,12,27
2022,Cameroon,CMR,Dem. Rep. of the Congo,COD,0,0,0,5,0,0,5,0,0,0,5,0,0,5,10
2022,Congo,COG,Dem. Rep. of the Congo,COD,20,44,48,126,21,0,259,21,58,47,219,53,0,398,657
2022,Eritrea,ERI,Dem. Rep. of the Congo,COD,5,0,0,7,0,0,12,0,0,0,0,0,0,0,12
2022,Ethiopia,ETH,Dem. Rep. of the Congo,COD,0,5,0,0,0,0,5,0,0,0,0,0,0,0,5
2022,Palestinian,PSE,Dem. Rep. of the Congo,COD,0,0,0,0,0,0,0,0,0,0,5,0,0,5,5
2022,Cote d'Ivoire,CIV,Dem. Rep. of the Congo,COD,0,7,0,0,0,0,7,0,5,0,5,0,0,10,17
2022,Liberia,LBR,Dem. Rep. of the Congo,COD,0,5,0,0,0,0,5,0,0,0,0,0,0,0,5
2022,Mali,MLI,Dem. Rep. of the Congo,COD,0,0,0,0,0,0,0,0,9,0,0,0,0,9,9
2022,Niger,NER,Dem. Rep. of the Congo,COD,0,0,5,0,0,0,5,0,0,5,0,0,0,5,10
2022,Rwanda,RWA,Dem. Rep. of the Congo,COD,15592,26369,19350,41655,2860,0,105826,16328,28246,19307,35607,3577,0,103065,208891
2022,Somalia,SOM,Dem. Rep. of the Congo,COD,0,9,7,31,0,0,47,8,5,0,121,5,0,139,186
2022,South Sudan,SSD,Dem. Rep. of the Congo,COD,3256,7494,4873,12533,1345,0,29501,3251,7462,5007,9890,928,0,26538,56039
2022,Sudan,SDN,Dem. Rep. of the Congo,COD,0,0,13,5,0,0,18,0,8,0,38,5,0,51,69
2022,Syrian Arab Rep.,SYR,Dem. Rep. of the Congo,COD,0,0,0,5,0,0,5,5,0,0,20,0,0,25,30
2022,Uganda,UGA,Dem. Rep. of the Congo,COD,0,9,0,8,0,0,17,0,0,5,5,0,0,10,27
2022,Zimbabwe,ZWE,Dem. Rep. of the Congo,COD,0,0,0,0,0,0,0,5,0,0,0,0,0,5,5
2022,Dem. Rep. of the Congo,COD,Comoros,COM,0,0,0,6,0,0,6,0,0,0,6,0,0,6,12
2022,Yemen,YEM,Comoros,COM,0,0,0,5,0,0,5,0,0,0,0,0,0,0,5
2022,Afghanistan,AFG,Colombia,COL,0,0,0,0,0,0,0,0,0,0,9,0,0,9,9
2022,Bolivia (Plurinational State of),BOL,Colombia,COL,0,0,0,0,0,0,0,0,0,0,5,0,0,5,5
2022,Cuba,CUB,Colombia,COL,0,0,0,17,0,8,25,0,0,5,57,0,0,62,320
2022,Dominican Rep.,DOM,Colombia,COL,0,0,0,0,0,0,0,0,0,0,0,0,0,0,5
2022,Ecuador,ECU,Colombia,COL,0,0,5,0,0,0,5,0,0,0,0,0,0,0,28
2022,Eritrea,ERI,Colombia,COL,0,0,0,0,0,0,0,0,0,0,5,0,0,5,5
2022,Ethiopia,ETH,Colombia,COL,0,0,0,0,0,0,0,0,0,0,7,0,0,7,7
2022,Ghana,GHA,Colombia,COL,0,0,0,5,0,0,5,0,0,0,0,0,0,0,5
2022,Haiti,HTI,Colombia,COL,0,0,0,0,0,0,0,0,0,0,0,0,0,0,7
2022,Honduras,HND,Colombia,COL,0,0,5,0,0,0,5,0,0,0,0,0,0,0,5
2022,Hungary,HUN,Colombia,COL,0,0,0,0,0,0,0,0,0,0,0,5,0,5,5
2022,Iraq,IRQ,Colombia,COL,0,0,0,0,0,0,0,0,0,0,8,0,0,8,8
2022,Liberia,LBR,Colombia,COL,0,0,0,0,0,0,0,0,0,0,5,0,0,5,5
2022,Nicaragua,NIC,Colombia,COL,0,0,0,0,0,5,5,0,0,0,0,0,5,5,10
2022,Peru,PER,Colombia,COL,0,0,0,0,0,0,0,0,0,0,0,0,0,0,10
2022,Russian Federation,RUS,Colombia,COL,0,0,0,0,0,0,0,0,0,0,0,0,0,0,29
2022,El Salvador,SLV,Colombia,COL,0,0,0,7,0,0,7,0,0,0,0,0,0,0,7
2022,Sierra Leone,SLE,Colombia,COL,0,0,0,0,0,0,0,0,0,0,5,0,0,5,5
2022,Somalia,SOM,Colombia,COL,0,0,0,0,0,0,0,0,0,0,11,0,0,11,11
2022,Serbia and Kosovo: S/RES/1244 (1999),SRB,Colombia,COL,0,0,0,0,0,0,0,0,0,0,0,5,0,5,5
2022,Syrian Arab Rep.,SYR,Colombia,COL,0,0,0,0,0,0,0,0,0,0,13,0,0,13,18
2022,Türkiye,TUR,Colombia,COL,0,7,0,0,0,0,7,0,0,0,0,0,0,0,7
2022,Unknown ,UNK,Colombia,COL,0,0,0,0,0,0,0,0,0,0,0,5,0,5,11
2022,Ukraine,UKR,Colombia,COL,0,0,0,0,0,0,0,0,0,0,0,0,8,8,29
2022,Venezuela (Bolivarian Republic of),VEN,Colombia,COL,124208,126024,125218,867904,43490,2540,1289384,125144,126870,126018,778879,28740,2553,1188204,2477588
2022,Angola,AGO,Costa Rica,CRI,0,0,0,0,0,0,0,0,0,0,0,0,0,0,64
2022,Egypt,EGY,Costa Rica,CRI,0,0,0,0,0,0,0,0,0,0,0,0,0,0,5
2022,Argentina,ARG,Costa Rica,CRI,0,0,0,0,0,0,0,0,0,0,0,0,0,0,77
2022,Australia,AUS,Costa Rica,CRI,0,0,0,0,0,0,0,0,0,0,0,0,0,0,6
2022,Burundi,BDI,Costa Rica,CRI,0,0,0,0,0,0,0,0,0,0,0,0,0,0,9
2022,Bangladesh,BGD,Costa Rica,CRI,0,0,0,0,0,0,0,0,0,0,0,0,0,0,16
2022,Burkina Faso,BFA,Costa Rica,CRI,0,0,0,0,0,0,0,0,0,0,0,0,0,0,5
2022,Belarus,BLR,Costa Rica,CRI,0,0,0,0,0,0,0,0,0,0,0,0,0,0,5
2022,Bolivia (Plurinational State of),BOL,Costa Rica,CRI,0,0,0,0,0,0,0,0,0,0,0,0,0,0,21
2022,Brazil,BRA,Costa Rica,CRI,0,0,0,0,0,0,0,0,0,0,0,0,0,0,167
2022,Belize,BLZ,Costa Rica,CRI,0,0,0,0,0,0,0,0,0,0,0,0,0,0,5
2022,Canada,CAN,Costa Rica,CRI,0,0,0,0,0,0,0,0,0,0,0,0,0,0,7
2022,China,CHN,Costa Rica,CRI,0,0,0,0,0,0,0,0,0,0,0,0,0,0,373
2022,Chile,CHL,Costa Rica,CRI,0,0,0,0,0,0,0,0,0,0,0,0,0,0,64
2022,Cameroon,CMR,Costa Rica,CRI,0,0,0,0,0,0,0,0,0,0,0,0,0,0,22
2022,Congo,COG,Costa Rica,CRI,0,0,0,0,0,0,0,0,0,0,0,0,0,0,57
2022,Dem. Rep. of the Congo,COD,Costa Rica,CRI,0,0,0,0,0,0,0,0,0,0,0,0,0,0,77
2022,Colombia,COL,Costa Rica,CRI,0,0,0,0,0,0,0,0,0,0,0,0,0,0,4859
2022,Cuba,CUB,Costa Rica,CRI,0,0,0,0,0,0,0,0,0,0,0,0,0,0,4211
2022,Czechia,CZE,Costa Rica,CRI,0,0,0,0,0,0,0,0,0,0,0,0,0,0,5
2022,Dominican Rep.,DOM,Costa Rica,CRI,0,0,0,0,0,0,0,0,0,0,0,0,0,0,175
2022,Ecuador,ECU,Costa Rica,CRI,0,0,0,0,0,0,0,0,0,0,0,0,0,0,131
2022,Eritrea,ERI,Costa Rica,CRI,0,0,0,0,0,0,0,0,0,0,0,0,0,0,7
2022,Ethiopia,ETH,Costa Rica,CRI,0,0,0,0,0,0,0,0,0,0,0,0,0,0,5
2022,French Guiana,GUF,Costa Rica,CRI,0,0,0,0,0,0,0,0,0,0,0,0,0,0,5
2022,Gambia,GMB,Costa Rica,CRI,0,0,0,0,0,0,0,0,0,0,0,0,0,0,5
2022,United Kingdom of Great Britain and Northern Ireland,GBR,Costa Rica,CRI,0,0,0,0,0,0,0,0,0,0,0,0,0,0,5
2022,Germany,DEU,Costa Rica,CRI,0,0,0,0,0,0,0,0,0,0,0,0,0,0,14
2022,Ghana,GHA,Costa Rica,CRI,0,0,0,0,0,0,0,0,0,0,0,0,0,0,61
2022,Greece,GRC,Costa Rica,CRI,0,0,0,0,0,0,0,0,0,0,0,0,0,0,5
2022,Guatemala,GTM,Costa Rica,CRI,0,0,0,0,0,0,0,0,0,0,0,0,0,0,165
2022,Guyana,GUY,Costa Rica,CRI,0,0,0,0,0,0,0,0,0,0,0,0,0,0,11
2022,Haiti,HTI,Costa Rica,CRI,0,0,0,0,0,0,0,0,0,0,0,0,0,0,899
2022,Honduras,HND,Costa Rica,CRI,0,0,0,0,0,0,0,0,0,0,0,0,0,0,1428
2022,Cote d'Ivoire,CIV,Costa Rica,CRI,0,0,0,0,0,0,0,0,0,0,0,0,0,0,6
2022,India,IND,Costa Rica,CRI,0,0,0,0,0,0,0,0,0,0,0,0,0,0,12
2022,Indonesia,IDN,Costa Rica,CRI,0,0,0,0,0,0,0,0,0,0,0,0,0,0,5
2022,Iran (Islamic Rep. of),IRN,Costa Rica,CRI,0,0,0,0,0,0,0,0,0,0,0,0,0,0,10
2022,Iraq,IRQ,Costa Rica,CRI,0,0,0,0,0,0,0,0,0,0,0,0,0,0,10
2022,Israel,ISR,Costa Rica,CRI,0,0,0,0,0,0,0,0,0,0,0,0,0,0,6
2022,Italy,ITA,Costa Rica,CRI,0,0,0,0,0,0,0,0,0,0,0,0,0,0,13
2022,Jamaica,JAM,Costa Rica,CRI,0,0,0,0,0,0,0,0,0,0,0,0,0,0,53
2022,Kazakhstan,KAZ,Costa Rica,CRI,0,0,0,0,0,0,0,0,0,0,0,0,0,0,5
2022,Lebanon,LBN,Costa Rica,CRI,0,0,0,0,0,0,0,0,0,0,0,0,0,0,5
2022,Latvia,LVA,Costa Rica,CRI,0,0,0,0,0,0,0,0,0,0,0,0,0,0,5
2022,Mexico,MEX,Costa Rica,CRI,0,0,0,0,0,0,0,0,0,0,0,0,0,0,106
2022,Namibia,NAM,Costa Rica,CRI,0,0,0,0,0,0,0,0,0,0,0,0,0,0,5
2022,Nepal,NPL,Costa Rica,CRI,0,0,0,0,0,0,0,0,0,0,0,0,0,0,102
2022,Niger,NER,Costa Rica,CRI,0,0,0,0,0,0,0,0,0,0,0,0,0,0,5
2022,Nicaragua,NIC,Costa Rica,CRI,1375,5167,3927,103447,14279,0,128195,1425,3704,3501,76159,11224,0,96013,224208
2022,Nigeria,NGA,Costa Rica,CRI,0,0,0,0,0,0,0,0,0,0,0,0,0,0,24
2022,Pakistan,PAK,Costa Rica,CRI,0,0,0,0,0,0,0,0,0,0,0,0,0,0,17
2022,Panama,PAN,Costa Rica,CRI,0,0,0,0,0,0,0,0,0,0,0,0,0,0,105
2022,Paraguay,PRY,Costa Rica,CRI,0,0,0,0,0,0,0,0,0,0,0,0,0,0,5
2022,Peru,PER,Costa Rica,CRI,0,0,0,0,0,0,0,0,0,0,0,0,0,0,103
2022,Philippines,PHL,Costa Rica,CRI,0,0,0,0,0,0,0,0,0,0,0,0,0,0,5
2022,Poland,POL,Costa Rica,CRI,0,0,0,0,0,0,0,0,0,0,0,0,0,0,5
2022,Romania,ROU,Costa Rica,CRI,0,0,0,0,0,0,0,0,0,0,0,0,0,0,8
2022,South Africa,ZAF,Costa Rica,CRI,0,0,0,0,0,0,0,0,0,0,0,0,0,0,11
2022,Russian Federation,RUS,Costa Rica,CRI,0,0,0,0,0,0,0,0,0,0,0,0,0,0,383
2022,El Salvador,SLV,Costa Rica,CRI,0,0,0,0,0,0,0,0,0,0,0,0,0,0,1825
2022,Senegal,SEN,Costa Rica,CRI,0,0,0,0,0,0,0,0,0,0,0,0,0,0,5
2022,Somalia,SOM,Costa Rica,CRI,0,0,0,0,0,0,0,0,0,0,0,0,0,0,14
2022,Spain,ESP,Costa Rica,CRI,0,0,0,0,0,0,0,0,0,0,0,0,0,0,11
2022,Viet Nam,VNM,Costa Rica,CRI,0,0,0,0,0,0,0,0,0,0,0,0,0,0,7
2022,Syrian Arab Rep.,SYR,Costa Rica,CRI,0,0,0,0,0,0,0,0,0,0,0,0,0,0,40
2022,Türkiye,TUR,Costa Rica,CRI,0,0,0,0,0,0,0,0,0,0,0,0,0,0,8
2022,Ukraine,UKR,Costa Rica,CRI,0,0,0,0,0,0,0,0,0,0,0,0,0,0,53
2022,Uruguay,URY,Costa Rica,CRI,0,0,0,0,0,0,0,0,0,0,0,0,0,0,6
2022,United States of America,USA,Costa Rica,CRI,0,0,0,0,0,0,0,0,0,0,0,0,0,0,52
2022,Venezuela (Bolivarian Republic of),VEN,Costa Rica,CRI,0,0,0,0,0,0,0,0,0,0,0,0,0,0,30107
2022,Zimbabwe,ZWE,Costa Rica,CRI,0,0,0,0,0,0,0,0,0,0,0,0,0,0,5
2022,Afghanistan,AFG,Cuba,CUB,0,0,0,0,0,0,0,0,0,0,12,0,0,12,12
2022,Eritrea,ERI,Cuba,CUB,0,0,0,0,0,0,0,0,0,0,5,0,0,5,5
2022,Haiti,HTI,Cuba,CUB,0,5,0,0,0,0,5,0,0,0,0,0,0,0,5
2022,Iran (Islamic Rep. of),IRN,Cuba,CUB,0,0,0,5,0,0,5,0,0,0,5,0,0,5,10
2022,Sudan,SDN,Cuba,CUB,0,0,0,0,0,0,0,0,0,0,7,0,0,7,7
2022,Syrian Arab Rep.,SYR,Cuba,CUB,0,8,0,5,0,0,13,0,0,0,17,5,0,22,35
2022,Western Sahara,ESH,Cuba,CUB,0,0,0,15,0,0,15,0,0,0,81,0,0,81,96
2022,Yemen,YEM,Cuba,CUB,0,0,0,0,0,0,0,0,0,0,12,0,0,12,12
2022,Venezuela (Bolivarian Republic of),VEN,Curacao ,CUW,0,0,0,0,0,8000,8000,0,0,0,0,0,6000,6000,14000
2022,Afghanistan,AFG,Cyprus,CYP,0,0,0,0,0,366,366,0,0,0,0,0,1305,1305,1714
2022,Algeria,DZA,Cyprus,CYP,0,0,0,0,0,0,0,0,0,0,0,0,0,0,13
2022,Angola,AGO,Cyprus,CYP,0,0,0,0,0,6,6,0,0,0,0,0,17,17,23
2022,Egypt,EGY,Cyprus,CYP,0,0,0,0,0,77,77,0,0,0,0,0,244,244,446
2022,Armenia,ARM,Cyprus,CYP,0,0,0,0,0,7,7,0,0,0,0,0,12,12,45
2022,Burundi,BDI,Cyprus,CYP,0,0,0,0,0,22,22,0,0,0,0,0,37,37,59
2022,Bangladesh,BGD,Cyprus,CYP,0,0,0,0,0,72,72,0,0,0,0,0,1575,1575,1659
2022,Burkina Faso,BFA,Cyprus,CYP,0,0,0,0,0,0,0,0,0,0,0,0,0,0,10
2022,Belarus,BLR,Cyprus,CYP,0,0,0,0,0,6,6,0,0,0,0,0,0,0,6
2022,Bosnia and Herzegovina,BIH,Cyprus,CYP,0,0,0,0,0,0,0,0,0,0,0,0,0,0,15
2022,China,CHN,Cyprus,CYP,0,0,0,0,0,7,7,0,0,0,0,0,6,6,18
2022,Cameroon,CMR,Cyprus,CYP,0,0,0,0,0,1391,1391,0,0,0,0,0,2074,2074,3653
2022,Congo,COG,Cyprus,CYP,0,0,0,0,0,95,95,0,0,0,0,0,115,115,222
2022,Dem. Rep. of the Congo,COD,Cyprus,CYP,0,0,0,0,0,1881,1881,0,0,0,0,0,2801,2801,4733
2022,Comoros,COM,Cyprus,CYP,0,0,0,0,0,9,9,0,0,0,0,0,0,0,9
2022,Colombia,COL,Cyprus,CYP,0,0,0,0,0,0,0,0,0,0,0,0,0,0,5
2022,Djibouti,DJI,Cyprus,CYP,0,0,0,0,0,7,7,0,0,0,0,0,5,5,12
2022,Eritrea,ERI,Cyprus,CYP,0,0,0,0,0,0,0,0,0,0,0,0,0,0,54
2022,Ethiopia,ETH,Cyprus,CYP,0,0,0,0,0,19,19,0,0,0,0,0,8,8,37
2022,Gambia,GMB,Cyprus,CYP,0,0,0,0,0,7,7,0,0,0,0,0,49,49,62
2022,Palestinian,PSE,Cyprus,CYP,0,0,0,0,0,69,69,0,0,0,0,0,207,207,2513
2022,Georgia,GEO,Cyprus,CYP,0,0,0,0,0,119,119,0,0,0,0,0,197,197,401
2022,Ghana,GHA,Cyprus,CYP,0,0,0,0,0,12,12,0,0,0,0,0,37,37,49
2022,Guinea-Bissau,GNB,Cyprus,CYP,0,0,0,0,0,0,0,0,0,0,0,0,0,0,5
2022,Guinea,GIN,Cyprus,CYP,0,0,0,0,0,109,109,0,0,0,0,0,407,407,531
2022,Haiti,HTI,Cyprus,CYP,0,0,0,0,0,9,9,0,0,0,0,0,8,8,17
2022,Cote d'Ivoire,CIV,Cyprus,CYP,0,0,0,0,0,21,21,0,0,0,0,0,87,87,113
2022,India,IND,Cyprus,CYP,0,0,0,0,0,283,283,0,0,0,0,0,849,849,1142
2022,Iran (Islamic Rep. of),IRN,Cyprus,CYP,0,0,0,0,0,223,223,0,0,0,0,0,425,425,1332
2022,Iraq,IRQ,Cyprus,CYP,0,0,0,0,0,163,163,0,0,0,0,0,184,184,1360
2022,Jordan,JOR,Cyprus,CYP,0,0,0,0,0,34,34,0,0,0,0,0,53,53,144
2022,Kazakhstan,KAZ,Cyprus,CYP,0,0,0,0,0,0,0,0,0,0,0,0,0,0,5
2022,Kenya,KEN,Cyprus,CYP,0,0,0,0,0,8,8,0,0,0,0,0,0,0,8
2022,Kyrgyzstan,KGZ,Cyprus,CYP,0,0,0,0,0,0,0,0,0,0,0,0,0,0,5
2022,Liberia,LBR,Cyprus,CYP,0,0,0,0,0,132,132,0,0,0,0,0,231,231,369
2022,Libya,LBY,Cyprus,CYP,0,0,0,0,0,0,0,0,0,0,0,0,0,0,12
2022,Lebanon,LBN,Cyprus,CYP,0,0,0,0,0,31,31,0,0,0,0,0,54,54,148
2022,Sri Lanka,LKA,Cyprus,CYP,0,0,0,0,0,123,123,0,0,0,0,0,161,161,316
2022,Rep. of Moldova,MDA,Cyprus,CYP,0,0,0,0,0,12,12,0,0,0,0,0,5,5,35
2022,Mali,MLI,Cyprus,CYP,0,0,0,0,0,0,0,0,0,0,0,0,0,0,6
2022,Mongolia,MNG,Cyprus,CYP,0,0,0,0,0,14,14,0,0,0,0,0,13,13,27
2022,Morocco,MAR,Cyprus,CYP,0,0,0,0,0,6,6,0,0,0,0,0,0,0,6
2022,Nepal,NPL,Cyprus,CYP,0,0,0,0,0,430,430,0,0,0,0,0,361,361,791
2022,Niger,NER,Cyprus,CYP,0,0,0,0,0,0,0,0,0,0,0,0,0,0,7
2022,Nigeria,NGA,Cyprus,CYP,0,0,0,0,0,755,755,0,0,0,0,0,3606,3606,4395
2022,Pakistan,PAK,Cyprus,CYP,0,0,0,0,0,179,179,0,0,0,0,0,1582,1582,1795
2022,Philippines,PHL,Cyprus,CYP,0,0,0,0,0,112,112,0,0,0,0,0,28,28,152
2022,South Africa,ZAF,Cyprus,CYP,0,0,0,0,0,0,0,0,0,0,0,0,0,0,5
2022,Russian Federation,RUS,Cyprus,CYP,0,0,0,0,0,43,43,0,0,0,0,0,52,52,173
2022,Rwanda,RWA,Cyprus,CYP,0,0,0,0,0,11,11,0,0,0,0,0,15,15,31
2022,Senegal,SEN,Cyprus,CYP,0,0,0,0,0,7,7,0,0,0,0,0,33,33,40
2022,Sierra Leone,SLE,Cyprus,CYP,0,0,0,0,0,262,262,0,0,0,0,0,483,483,778
2022,Somalia,SOM,Cyprus,CYP,0,0,0,0,0,684,684,0,0,0,0,0,917,917,2023
2022,Serbia and Kosovo: S/RES/1244 (1999),SRB,Cyprus,CYP,0,0,0,0,0,7,7,0,0,0,0,0,0,0,66
2022,Viet Nam,VNM,Cyprus,CYP,0,0,0,0,0,217,217,0,0,0,0,0,59,59,281
2022,Stateless,XXA,Cyprus,CYP,0,0,0,0,0,0,0,0,0,0,0,0,0,0,76
2022,Sudan,SDN,Cyprus,CYP,0,0,0,0,0,0,0,0,0,0,0,0,0,0,23
2022,Syrian Arab Rep.,SYR,Cyprus,CYP,0,0,0,0,0,1414,1414,0,0,0,0,0,8090,8090,20406
2022,Tajikistan,TJK,Cyprus,CYP,0,0,0,0,0,0,0,0,0,0,0,0,0,0,5
2022,Turkmenistan,TKM,Cyprus,CYP,0,0,0,0,0,6,6,0,0,0,0,0,6,6,12
2022,Togo,TGO,Cyprus,CYP,0,0,0,0,0,6,6,0,0,0,0,0,16,16,22
2022,Tunisia,TUN,Cyprus,CYP,0,0,0,0,0,0,0,0,0,0,0,0,0,0,5
2022,Türkiye,TUR,Cyprus,CYP,0,0,0,0,0,42,42,0,0,0,0,0,295,295,603
2022,Uganda,UGA,Cyprus,CYP,0,0,0,0,0,5,5,0,0,0,0,0,0,0,5
2022,Unknown ,UNK,Cyprus,CYP,0,0,0,0,0,0,0,0,0,0,0,0,0,0,52
2022,Ukraine,UKR,Cyprus,CYP,0,0,0,0,0,8750,8750,0,0,0,0,0,3784,3784,12566
2022,Uzbekistan,UZB,Cyprus,CYP,0,0,0,0,0,0,0,0,0,0,0,0,0,0,10
2022,Yemen,YEM,Cyprus,CYP,0,0,0,0,0,12,12,0,0,0,0,0,18,18,91
2022,Zimbabwe,ZWE,Cyprus,CYP,0,0,0,0,0,17,17,0,0,0,0,0,8,8,25
2022,Afghanistan,AFG,Czechia,CZE,8,5,0,25,0,0,38,5,14,0,12,0,0,31,229
2022,Algeria,DZA,Czechia,CZE,0,0,0,0,0,0,0,0,0,0,5,0,0,5,19
2022,Egypt,EGY,Czechia,CZE,0,0,0,0,0,0,0,0,0,0,0,0,0,0,17
2022,Armenia,ARM,Czechia,CZE,0,0,0,0,0,0,0,0,0,0,0,0,0,0,19
2022,Azerbaijan,AZE,Czechia,CZE,0,0,5,0,0,0,5,0,0,5,13,0,0,18,52
2022,Burundi,BDI,Czechia,CZE,0,0,0,0,0,0,0,0,0,0,0,0,0,0,5
2022,Belarus,BLR,Czechia,CZE,0,0,0,5,0,0,5,0,0,0,19,0,0,19,204
2022,China,CHN,Czechia,CZE,0,0,0,0,0,0,0,0,0,0,0,0,0,0,69
2022,Dem. Rep. of the Congo,COD,Czechia,CZE,0,0,0,0,0,0,0,0,0,0,0,0,0,0,10
2022,Colombia,COL,Czechia,CZE,0,0,0,0,0,0,0,0,0,0,0,0,0,0,5
2022,Cuba,CUB,Czechia,CZE,0,0,0,0,0,0,0,0,0,0,0,0,0,0,33
2022,Eritrea,ERI,Czechia,CZE,0,0,0,0,0,0,0,0,0,0,0,0,0,0,11
2022,Ethiopia,ETH,Czechia,CZE,0,0,0,0,0,0,0,0,0,0,0,0,0,0,6
2022,Georgia,GEO,Czechia,CZE,0,0,0,0,0,0,0,0,0,0,0,0,0,0,32
2022,India,IND,Czechia,CZE,0,0,0,0,0,0,0,0,0,0,0,0,0,0,10
2022,Iran (Islamic Rep. of),IRN,Czechia,CZE,0,0,0,5,0,0,5,0,0,0,0,0,0,0,16
2022,Iraq,IRQ,Czechia,CZE,0,0,0,0,0,0,0,0,0,6,0,0,0,6,82
2022,Kazakhstan,KAZ,Czechia,CZE,0,0,0,0,0,0,0,0,0,0,0,0,0,0,66
2022,Kyrgyzstan,KGZ,Czechia,CZE,0,0,0,0,0,0,0,0,0,0,0,0,0,0,27
2022,Libya,LBY,Czechia,CZE,0,0,0,0,0,0,0,0,5,0,0,0,0,5,24
2022,Lebanon,LBN,Czechia,CZE,0,0,0,0,0,0,0,0,0,0,0,0,0,0,5
2022,Sri Lanka,LKA,Czechia,CZE,0,0,0,0,0,0,0,0,0,0,0,0,0,0,7
2022,Rep. of Moldova,MDA,Czechia,CZE,0,0,0,0,0,0,0,0,0,0,0,0,0,0,18
2022,Mongolia,MNG,Czechia,CZE,0,0,0,0,0,0,0,0,0,0,0,0,0,0,15
2022,Morocco,MAR,Czechia,CZE,0,0,0,0,0,0,0,0,0,0,0,0,0,0,5
2022,Myanmar,MMR,Czechia,CZE,0,0,0,11,0,0,11,0,0,5,0,0,0,5,166
2022,Nigeria,NGA,Czechia,CZE,0,0,0,0,0,0,0,0,0,0,13,0,0,13,20
2022,Pakistan,PAK,Czechia,CZE,0,0,0,0,0,0,0,0,0,0,0,0,0,0,14
2022,Russian Federation,RUS,Czechia,CZE,0,0,0,10,0,0,10,0,0,0,22,0,0,22,244
2022,Saudi Arabia,SAU,Czechia,CZE,0,0,0,0,0,0,0,0,0,0,0,0,0,0,5
2022,Sierra Leone,SLE,Czechia,CZE,0,0,0,0,0,0,0,0,0,0,0,0,0,0,5
2022,Somalia,SOM,Czechia,CZE,0,0,0,0,0,0,0,0,0,0,0,0,0,0,26
2022,Serbia and Kosovo: S/RES/1244 (1999),SRB,Czechia,CZE,0,0,0,0,0,0,0,0,0,0,0,0,0,0,5
2022,Viet Nam,VNM,Czechia,CZE,0,0,0,0,0,0,0,0,0,0,22,0,0,22,146
2022,Stateless,XXA,Czechia,CZE,0,0,0,0,0,0,0,0,0,0,0,0,0,0,68
2022,Sudan,SDN,Czechia,CZE,0,0,0,0,0,0,0,0,0,0,0,0,0,0,7
2022,Syrian Arab Rep.,SYR,Czechia,CZE,0,0,0,0,0,0,0,0,0,0,6,0,0,6,347
2022,Tajikistan,TJK,Czechia,CZE,0,0,0,0,0,0,0,0,0,0,0,0,0,0,5
2022,Turkmenistan,TKM,Czechia,CZE,0,0,0,0,0,0,0,0,0,0,0,0,0,0,7
2022,Türkiye,TUR,Czechia,CZE,0,0,0,0,0,0,0,0,0,0,57,0,0,57,87
2022,Uganda,UGA,Czechia,CZE,0,0,0,0,0,0,0,0,0,0,0,0,0,0,5
2022,Unknown ,UNK,Czechia,CZE,0,0,0,0,0,0,0,0,0,0,0,0,0,0,307
2022,Ukraine,UKR,Czechia,CZE,0,0,0,22,5,272662,272689,0,0,10,43,0,160359,160412,433638
2022,Uzbekistan,UZB,Czechia,CZE,0,0,0,0,0,0,0,0,0,0,36,0,0,36,72
2022,Venezuela (Bolivarian Republic of),VEN,Czechia,CZE,0,0,0,0,0,0,0,0,0,0,0,0,0,0,11
2022,Yemen,YEM,Czechia,CZE,0,0,0,0,0,0,0,0,0,0,0,0,0,0,27
2022,Afghanistan,AFG,Denmark,DNK,0,0,0,0,0,221,221,0,0,0,0,0,257,257,2103
2022,Albania,ALB,Denmark,DNK,0,0,0,0,0,0,0,0,0,0,0,0,0,0,5
2022,Algeria,DZA,Denmark,DNK,0,0,0,0,0,0,0,0,0,0,0,0,0,0,15
2022,Angola,AGO,Denmark,DNK,0,0,0,0,0,0,0,0,0,0,0,0,0,0,5
2022,Egypt,EGY,Denmark,DNK,0,0,0,0,0,0,0,0,0,0,0,0,0,0,31
2022,Armenia,ARM,Denmark,DNK,0,0,0,0,0,0,0,0,0,0,0,0,0,0,106
2022,Azerbaijan,AZE,Denmark,DNK,0,0,0,0,0,0,0,0,0,0,0,0,0,0,51
2022,Bahrain,BHR,Denmark,DNK,0,0,0,0,0,0,0,0,0,0,0,0,0,0,5
2022,Burundi,BDI,Denmark,DNK,0,0,0,0,0,0,0,0,0,0,0,0,0,0,5
2022,Bangladesh,BGD,Denmark,DNK,0,0,0,0,0,0,0,0,0,0,0,0,0,0,22
2022,Belarus,BLR,Denmark,DNK,0,0,0,0,0,11,11,0,0,0,0,0,27,27,52
2022,Brazil,BRA,Denmark,DNK,0,0,0,0,0,0,0,0,0,0,0,0,0,0,5
2022,Bosnia and Herzegovina,BIH,Denmark,DNK,0,0,0,0,0,0,0,0,0,0,0,0,0,0,5
2022,China,CHN,Denmark,DNK,0,0,0,0,0,5,5,0,0,0,0,0,9,9,31
2022,Cameroon,CMR,Denmark,DNK,0,0,0,0,0,0,0,0,0,0,0,0,9,9,18
2022,Dem. Rep. of the Congo,COD,Denmark,DNK,0,0,0,0,0,5,5,0,0,0,0,0,13,13,75
2022,Colombia,COL,Denmark,DNK,0,0,0,0,0,12,12,0,0,0,0,0,17,17,34
2022,Eritrea,ERI,Denmark,DNK,0,0,0,0,0,118,118,0,0,0,0,0,66,66,6120
2022,Ethiopia,ETH,Denmark,DNK,0,0,0,0,0,0,0,0,0,0,0,0,0,0,105
2022,Gambia,GMB,Denmark,DNK,0,0,0,0,0,0,0,0,0,0,0,0,0,0,10
2022,Georgia,GEO,Denmark,DNK,0,0,0,0,0,0,0,0,0,0,0,0,0,0,44
2022,Ghana,GHA,Denmark,DNK,0,0,0,0,0,0,0,0,0,0,0,0,0,0,13
2022,Guinea-Bissau,GNB,Denmark,DNK,0,0,0,0,0,0,0,0,0,0,0,0,0,0,5
2022,Cote d'Ivoire,CIV,Denmark,DNK,0,0,0,0,0,0,0,0,0,0,0,0,0,0,7
2022,India,IND,Denmark,DNK,0,0,0,0,0,5,5,0,0,0,0,0,17,17,22
2022,Iran (Islamic Rep. of),IRN,Denmark,DNK,0,0,0,0,0,53,53,0,0,0,0,0,98,98,2616
2022,Iraq,IRQ,Denmark,DNK,0,0,0,0,0,18,18,0,0,0,0,0,34,34,327
2022,Israel,ISR,Denmark,DNK,0,0,0,0,0,0,0,0,0,0,0,0,0,0,5
2022,Jordan,JOR,Denmark,DNK,0,0,0,0,0,0,0,0,0,0,0,0,0,0,19
2022,Kenya,KEN,Denmark,DNK,0,0,0,0,0,0,0,0,0,0,0,0,0,0,5
2022,Kyrgyzstan,KGZ,Denmark,DNK,0,0,0,0,0,0,0,0,0,0,0,0,0,0,5
2022,Libya,LBY,Denmark,DNK,0,0,0,0,0,0,0,0,0,0,0,0,0,0,5
2022,Lebanon,LBN,Denmark,DNK,0,0,0,0,0,0,0,0,0,0,0,0,0,0,37
2022,Sri Lanka,LKA,Denmark,DNK,0,0,0,0,0,6,6,0,0,0,0,0,0,0,39
2022,Lithuania,LTU,Denmark,DNK,0,0,0,0,0,0,0,0,0,0,0,0,0,0,5
2022,Rep. of Moldova,MDA,Denmark,DNK,0,0,0,0,0,0,0,0,0,0,0,0,0,0,20
2022,Malaysia,MYS,Denmark,DNK,0,0,0,0,0,0,0,0,0,0,0,0,0,0,5
2022,Mongolia,MNG,Denmark,DNK,0,0,0,0,0,5,5,0,0,0,0,0,5,5,10
2022,Morocco,MAR,Denmark,DNK,0,0,0,0,0,5,5,0,0,0,0,0,30,30,45
2022,Myanmar,MMR,Denmark,DNK,0,0,0,0,0,8,8,0,0,0,0,0,5,5,26
2022,Nicaragua,NIC,Denmark,DNK,0,0,0,0,0,0,0,0,0,0,0,0,0,0,13
2022,Nigeria,NGA,Denmark,DNK,0,0,0,0,0,5,5,0,0,0,0,0,21,21,46
2022,Pakistan,PAK,Denmark,DNK,0,0,0,0,0,5,5,0,0,0,0,0,13,13,76
2022,Philippines,PHL,Denmark,DNK,0,0,0,0,0,0,0,0,0,0,0,0,0,0,10
2022,Romania,ROU,Denmark,DNK,0,0,0,0,0,0,0,0,0,0,0,0,0,0,5
2022,Russian Federation,RUS,Denmark,DNK,0,0,0,0,0,43,43,0,0,0,0,0,55,55,658
2022,Rwanda,RWA,Denmark,DNK,0,0,0,0,0,0,0,0,0,0,0,0,0,0,14
2022,El Salvador,SLV,Denmark,DNK,0,0,0,0,0,0,0,0,0,0,0,0,0,0,5
2022,Somalia,SOM,Denmark,DNK,0,0,0,0,0,12,12,0,0,0,0,0,11,11,1127
2022,Serbia and Kosovo: S/RES/1244 (1999),SRB,Denmark,DNK,0,0,0,0,0,5,5,0,0,0,0,0,5,5,10
2022,Viet Nam,VNM,Denmark,DNK,0,0,0,0,0,5,5,0,0,0,0,0,7,7,52
2022,Stateless,XXA,Denmark,DNK,0,0,0,0,0,37,37,0,0,0,0,0,52,52,2979
2022,Sudan,SDN,Denmark,DNK,0,0,0,0,0,0,0,0,0,0,0,0,0,0,53
2022,Syrian Arab Rep.,SYR,Denmark,DNK,0,0,0,0,0,115,115,0,0,0,0,0,191,191,19459
2022,Thailand,THA,Denmark,DNK,0,0,0,0,0,0,0,0,0,0,0,0,0,0,11
2022,Tajikistan,TJK,Denmark,DNK,0,0,0,0,0,0,0,0,0,0,0,0,0,0,5
2022,Turkmenistan,TKM,Denmark,DNK,0,0,0,0,0,0,0,0,0,0,0,0,0,0,5
2022,Tunisia,TUN,Denmark,DNK,0,0,0,0,0,0,0,0,0,0,0,0,0,0,15
2022,Türkiye,TUR,Denmark,DNK,0,0,0,0,0,7,7,0,0,0,0,0,30,30,82
2022,Uganda,UGA,Denmark,DNK,0,0,0,0,0,0,0,0,0,0,0,0,0,0,76
2022,Ukraine,UKR,Denmark,DNK,0,0,0,0,0,22381,22381,0,0,0,0,0,11296,11296,33706
2022,United States of America,USA,Denmark,DNK,0,0,0,0,0,0,0,0,0,0,0,0,0,0,5
2022,Uzbekistan,UZB,Denmark,DNK,0,0,0,0,0,5,5,0,0,0,0,0,15,15,38
2022,Venezuela (Bolivarian Republic of),VEN,Denmark,DNK,0,0,0,0,0,0,0,0,0,0,0,0,7,7,12
2022,Yemen,YEM,Denmark,DNK,0,0,0,0,0,0,0,0,0,0,0,0,0,0,7
2022,Zambia,ZMB,Denmark,DNK,0,0,0,0,0,0,0,0,0,0,0,0,0,0,5
2022,Zimbabwe,ZWE,Denmark,DNK,0,0,0,0,0,0,0,0,0,0,0,0,0,0,11
2022,Dem. Rep. of the Congo,COD,Djibouti,DJI,5,0,0,10,0,0,15,0,0,0,5,0,0,5,20
2022,Eritrea,ERI,Djibouti,DJI,59,67,63,189,5,0,383,41,75,58,477,15,0,666,1049
2022,Ethiopia,ETH,Djibouti,DJI,677,1276,1030,3059,158,0,6200,703,1349,1102,2830,123,0,6107,12307
2022,Iraq,IRQ,Djibouti,DJI,0,0,0,0,0,0,0,0,0,5,8,0,0,13,13
2022,Mali,MLI,Djibouti,DJI,0,0,0,0,0,0,0,0,0,0,5,0,0,5,5
2022,Somalia,SOM,Djibouti,DJI,757,1304,1024,3443,277,0,6805,827,1316,1028,2809,331,0,6311,13116
2022,Sudan,SDN,Djibouti,DJI,0,0,0,0,0,0,0,0,5,0,5,0,0,10,10
2022,Syrian Arab Rep.,SYR,Djibouti,DJI,0,0,0,5,0,0,5,0,0,0,5,0,0,5,10
2022,Yemen,YEM,Djibouti,DJI,160,178,143,571,58,0,1110,163,199,161,1307,87,0,1917,3027
2022,Afghanistan,AFG,Dominican Rep.,DOM,0,0,0,0,0,0,0,0,0,0,0,0,0,0,8
2022,Colombia,COL,Dominican Rep.,DOM,0,0,0,0,0,0,0,0,0,0,0,0,0,0,12
2022,Cuba,CUB,Dominican Rep.,DOM,0,0,0,0,0,0,0,0,0,0,0,0,0,0,121
2022,Ecuador,ECU,Dominican Rep.,DOM,0,0,0,0,0,0,0,0,0,0,0,0,0,0,5
2022,Haiti,HTI,Dominican Rep.,DOM,0,0,0,0,0,0,0,0,0,0,0,0,0,0,951
2022,Honduras,HND,Dominican Rep.,DOM,0,0,0,0,0,0,0,0,0,0,0,0,0,0,5
2022,Sri Lanka,LKA,Dominican Rep.,DOM,0,0,0,0,0,0,0,0,0,0,0,0,0,0,5
2022,Nicaragua,NIC,Dominican Rep.,DOM,0,0,0,0,0,0,0,0,0,0,0,0,0,0,6
2022,Russian Federation,RUS,Dominican Rep.,DOM,0,0,0,0,0,0,0,0,0,0,0,0,0,0,9
2022,Syrian Arab Rep.,SYR,Dominican Rep.,DOM,0,0,0,0,0,0,0,0,0,0,0,0,0,0,5
2022,Unknown ,UNK,Dominican Rep.,DOM,0,0,0,0,0,0,0,0,0,0,0,0,0,0,19
2022,Ukraine,UKR,Dominican Rep.,DOM,0,0,0,0,0,0,0,0,0,0,0,0,0,0,14
2022,Venezuela (Bolivarian Republic of),VEN,Dominican Rep.,DOM,0,0,0,0,0,0,0,0,0,0,0,0,0,0,115283
2022,Afghanistan,AFG,Ecuador,ECU,0,0,9,53,8,0,70,0,5,5,58,9,0,77,147
2022,Albania,ALB,Ecuador,ECU,0,0,0,6,0,0,6,0,0,0,0,0,0,0,6
2022,Angola,AGO,Ecuador,ECU,0,0,0,0,0,0,0,0,0,0,5,0,0,5,5
2022,Egypt,EGY,Ecuador,ECU,0,0,0,5,0,0,5,0,0,0,14,0,0,14,19
2022,Argentina,ARG,Ecuador,ECU,0,5,0,0,0,0,5,0,0,0,0,0,0,0,5
2022,Bangladesh,BGD,Ecuador,ECU,0,0,0,0,0,0,0,0,0,0,10,0,0,10,10
2022,Burkina Faso,BFA,Ecuador,ECU,0,0,0,0,0,0,0,0,0,0,5,0,0,5,5
2022,Brazil,BRA,Ecuador,ECU,0,0,0,0,0,0,0,5,0,5,0,0,0,10,10
2022,China,CHN,Ecuador,ECU,0,0,5,6,0,0,11,0,0,0,6,0,0,6,17
2022,Chile,CHL,Ecuador,ECU,5,0,6,0,0,0,11,0,0,0,0,0,0,0,11
2022,Cameroon,CMR,Ecuador,ECU,0,0,0,6,0,0,6,0,0,0,20,0,0,20,26
2022,Congo,COG,Ecuador,ECU,0,0,0,0,0,0,0,0,0,0,12,0,0,12,12
2022,Dem. Rep. of the Congo,COD,Ecuador,ECU,0,0,0,13,0,0,13,0,0,0,0,0,0,0,13
2022,Colombia,COL,Ecuador,ECU,276,990,2209,22944,2756,0,29175,295,1060,2318,24616,3660,0,31949,61124
2022,Cuba,CUB,Ecuador,ECU,0,0,0,120,26,0,146,0,0,5,205,43,0,253,399
2022,Dominican Rep.,DOM,Ecuador,ECU,0,0,0,5,0,0,5,0,0,0,5,0,0,5,10
2022,Eritrea,ERI,Ecuador,ECU,0,0,0,0,0,0,0,0,0,0,16,0,0,16,16
2022,Ethiopia,ETH,Ecuador,ECU,0,0,0,0,0,0,0,0,0,0,5,0,0,5,5
2022,Palestinian,PSE,Ecuador,ECU,0,0,0,0,0,0,0,0,0,0,18,0,0,18,18
2022,Ghana,GHA,Ecuador,ECU,0,0,0,0,0,0,0,0,0,0,5,0,0,5,5
2022,Guinea,GIN,Ecuador,ECU,0,0,0,0,0,0,0,0,0,0,10,0,0,10,10
2022,Haiti,HTI,Ecuador,ECU,0,0,0,6,0,0,6,0,0,0,28,0,0,28,34
2022,Honduras,HND,Ecuador,ECU,0,0,5,0,0,0,5,0,0,0,0,0,0,0,5
2022,Cote d'Ivoire,CIV,Ecuador,ECU,0,0,0,0,0,0,0,0,0,0,5,0,0,5,5
2022,India,IND,Ecuador,ECU,0,0,0,0,0,0,0,0,0,0,5,5,0,10,10
2022,Iran (Islamic Rep. of),IRN,Ecuador,ECU,0,0,0,18,7,0,25,0,0,8,39,5,0,52,77
2022,Iraq,IRQ,Ecuador,ECU,0,0,0,8,0,0,8,0,0,0,41,7,0,48,56
2022,Liberia,LBR,Ecuador,ECU,0,0,0,0,0,0,0,0,0,0,6,0,0,6,6
2022,Lebanon,LBN,Ecuador,ECU,0,0,0,6,0,0,6,0,5,5,15,0,0,25,31
2022,Sri Lanka,LKA,Ecuador,ECU,0,0,0,5,0,0,5,0,0,0,18,0,0,18,23
2022,Mali,MLI,Ecuador,ECU,0,0,0,0,0,0,0,0,0,0,5,0,0,5,5
2022,Morocco,MAR,Ecuador,ECU,0,0,0,6,0,0,6,0,0,0,0,0,0,0,6
2022,Nepal,NPL,Ecuador,ECU,0,0,0,0,0,0,0,0,0,0,5,0,0,5,5
2022,Nicaragua,NIC,Ecuador,ECU,0,0,0,7,0,0,7,0,0,0,0,0,0,0,7
2022,Nigeria,NGA,Ecuador,ECU,0,0,0,10,0,0,10,0,0,0,48,0,0,48,58
2022,Pakistan,PAK,Ecuador,ECU,0,0,0,0,0,0,0,0,0,0,30,0,0,30,30
2022,Panama,PAN,Ecuador,ECU,0,0,5,0,0,0,5,0,0,0,0,0,0,0,5
2022,Peru,PER,Ecuador,ECU,0,0,5,58,8,0,71,7,5,0,73,17,0,102,173
2022,South Africa,ZAF,Ecuador,ECU,0,0,0,5,0,0,5,0,0,0,0,0,0,0,5
2022,Russian Federation,RUS,Ecuador,ECU,0,0,0,26,0,0,26,0,0,5,14,5,0,24,50
2022,Rwanda,RWA,Ecuador,ECU,5,0,0,0,0,0,5,0,0,0,0,0,0,0,5
2022,El Salvador,SLV,Ecuador,ECU,0,0,0,12,0,0,12,0,8,7,7,0,0,22,34
2022,Saudi Arabia,SAU,Ecuador,ECU,0,0,8,0,0,0,8,0,0,0,0,0,0,0,8
2022,Somalia,SOM,Ecuador,ECU,0,0,0,0,0,0,0,0,0,0,8,0,0,8,8
2022,Spain,ESP,Ecuador,ECU,0,0,5,0,0,0,5,0,0,0,0,0,0,0,5
2022,Viet Nam,VNM,Ecuador,ECU,0,0,0,0,0,0,0,0,0,0,5,0,0,5,5
2022,Sudan,SDN,Ecuador,ECU,0,0,0,0,0,0,0,0,0,0,5,0,0,5,5
2022,Syrian Arab Rep.,SYR,Ecuador,ECU,0,0,5,26,0,0,31,0,6,6,115,0,0,127,158
2022,Togo,TGO,Ecuador,ECU,0,0,0,0,0,0,0,0,0,0,5,0,0,5,5
2022,Türkiye,TUR,Ecuador,ECU,0,0,0,0,0,0,0,0,0,0,5,0,0,5,5
2022,United Arab Emirates,ARE,Ecuador,ECU,0,0,5,0,0,0,5,0,0,0,0,0,0,0,5
2022,Uganda,UGA,Ecuador,ECU,0,0,0,0,0,0,0,0,0,0,6,0,0,6,6
2022,Unknown ,UNK,Ecuador,ECU,0,0,0,0,5,0,5,0,0,0,7,5,0,12,17
2022,Ukraine,UKR,Ecuador,ECU,0,0,5,40,9,0,54,0,10,0,20,0,0,30,84
2022,United States of America,USA,Ecuador,ECU,0,0,0,0,0,0,0,0,0,0,13,0,0,13,13
2022,Uzbekistan,UZB,Ecuador,ECU,0,0,0,5,0,0,5,0,0,0,0,0,0,0,5
2022,Venezuela (Bolivarian Republic of),VEN,Ecuador,ECU,109,517,351,2309,87,267020,270393,110,533,385,2444,65,228284,231821,502214
2022,Western Sahara,ESH,Ecuador,ECU,0,0,0,0,0,0,0,0,0,0,5,0,0,5,5
2022,Yemen,YEM,Ecuador,ECU,0,8,7,30,0,0,45,0,6,6,60,0,0,72,117
2022,Zimbabwe,ZWE,Ecuador,ECU,0,0,0,5,0,0,5,0,0,0,10,0,0,10,15
2022,Ethiopia,ETH,Eritrea,ERI,0,5,0,0,0,0,5,0,5,0,5,0,0,10,15
2022,South Sudan,SSD,Eritrea,ERI,0,0,0,0,0,0,0,0,0,0,5,0,0,5,5
2022,Sudan,SDN,Eritrea,ERI,0,15,15,6,0,0,36,0,17,18,28,0,0,63,99
2022,Afghanistan,AFG,Estonia,EST,0,0,0,0,0,0,0,0,0,0,0,0,0,0,33
2022,Egypt,EGY,Estonia,EST,0,0,0,0,0,0,0,0,0,0,0,0,0,0,5
2022,Armenia,ARM,Estonia,EST,0,0,0,0,0,0,0,0,0,0,0,0,0,0,5
2022,Azerbaijan,AZE,Estonia,EST,0,0,0,0,0,0,0,0,0,0,0,0,0,0,19
2022,Belarus,BLR,Estonia,EST,0,0,0,0,0,0,0,0,0,0,0,0,0,0,37
2022,Eritrea,ERI,Estonia,EST,0,0,0,0,0,0,0,0,0,0,0,0,0,0,10
2022,Georgia,GEO,Estonia,EST,0,0,0,0,0,0,0,0,0,0,0,0,0,0,16
2022,Iran (Islamic Rep. of),IRN,Estonia,EST,0,0,0,0,0,0,0,0,0,0,0,0,0,0,5
2022,Iraq,IRQ,Estonia,EST,0,0,0,0,0,0,0,0,0,0,0,0,0,0,17
2022,Kazakhstan,KAZ,Estonia,EST,0,0,0,0,0,0,0,0,0,0,0,0,0,0,5
2022,Sri Lanka,LKA,Estonia,EST,0,0,0,0,0,0,0,0,0,0,0,0,0,0,5
2022,Rep. of Moldova,MDA,Estonia,EST,0,0,0,0,0,0,0,0,0,0,0,0,0,0,19
2022,Nigeria,NGA,Estonia,EST,0,0,0,0,0,0,0,0,0,0,0,0,0,0,8
2022,Pakistan,PAK,Estonia,EST,0,0,0,0,0,0,0,0,0,0,0,0,0,0,5
2022,Russian Federation,RUS,Estonia,EST,0,0,0,0,0,0,0,0,0,0,0,0,0,0,237
2022,Serbia and Kosovo: S/RES/1244 (1999),SRB,Estonia,EST,0,0,0,0,0,0,0,0,0,0,0,0,0,0,7
2022,Stateless,XXA,Estonia,EST,0,0,0,0,0,0,0,0,0,0,0,0,0,0,10
2022,Sudan,SDN,Estonia,EST,0,0,0,0,0,0,0,0,0,0,0,0,0,0,15
2022,Syrian Arab Rep.,SYR,Estonia,EST,0,0,0,0,0,0,0,0,0,0,0,0,0,0,107
2022,Turkmenistan,TKM,Estonia,EST,0,0,0,0,0,0,0,0,0,0,0,0,0,0,5
2022,Türkiye,TUR,Estonia,EST,0,0,0,0,0,0,0,0,0,0,0,0,0,0,35
2022,Ukraine,UKR,Estonia,EST,0,0,0,0,0,37536,37536,0,0,0,0,0,701,701,40816
2022,United States of America,USA,Estonia,EST,0,0,0,0,0,0,0,0,0,0,0,0,0,0,5
2022,Uzbekistan,UZB,Estonia,EST,0,0,0,0,0,0,0,0,0,0,0,0,0,0,5
2022,Yemen,YEM,Estonia,EST,0,0,0,0,0,0,0,0,0,0,0,0,0,0,6
2022,Egypt,EGY,Ethiopia,ETH,0,0,5,0,0,0,5,0,0,0,0,0,0,0,5
2022,Burundi,BDI,Ethiopia,ETH,7,10,10,37,0,0,64,0,0,14,53,0,0,67,131
2022,Chad,TCD,Ethiopia,ETH,0,0,0,0,0,0,0,0,0,0,5,0,0,5,5
2022,Dem. Rep. of the Congo,COD,Ethiopia,ETH,59,96,67,245,5,0,472,55,100,68,357,5,0,585,1057
2022,Cuba,CUB,Ethiopia,ETH,0,0,0,5,0,0,5,0,0,0,0,0,0,0,5
2022,Djibouti,DJI,Ethiopia,ETH,0,9,0,15,0,0,24,0,11,7,16,0,0,34,58
2022,Eritrea,ERI,Ethiopia,ETH,6297,14686,11855,51402,1473,0,85713,6553,15035,12944,41132,1689,0,77353,163066
2022,Palestinian,PSE,Ethiopia,ETH,0,0,0,0,0,0,0,0,5,0,8,0,0,13,13
2022,Cote d'Ivoire,CIV,Ethiopia,ETH,0,0,0,0,0,0,0,0,0,0,5,0,0,5,5
2022,Iraq,IRQ,Ethiopia,ETH,0,0,5,0,0,0,5,0,0,5,0,0,0,5,10
2022,Jordan,JOR,Ethiopia,ETH,0,0,0,8,0,0,8,0,6,0,5,0,0,11,19
2022,Kenya,KEN,Ethiopia,ETH,103,546,289,994,165,0,2097,124,580,321,768,133,0,1926,4023
2022,Lebanon,LBN,Ethiopia,ETH,0,0,0,7,0,0,7,0,6,0,5,0,0,11,18
2022,Mali,MLI,Ethiopia,ETH,0,0,0,0,0,0,0,0,0,0,5,0,0,5,5
2022,Nigeria,NGA,Ethiopia,ETH,0,0,0,0,0,0,0,0,5,0,5,0,0,10,10
2022,Rwanda,RWA,Ethiopia,ETH,0,0,0,5,0,0,5,0,0,0,13,0,0,13,18
2022,Somalia,SOM,Ethiopia,ETH,21147,29621,24868,53067,2870,0,131573,21824,30315,25770,39266,3145,0,120320,251893
2022,South Sudan,SSD,Ethiopia,ETH,32158,58968,35991,86346,6357,0,219820,33595,59876,40674,53031,2628,0,189804,409624
2022,Sudan,SDN,Ethiopia,ETH,4278,5908,3570,8835,667,0,23258,4389,6120,3968,10183,768,0,25428,48686
2022,Syrian Arab Rep.,SYR,Ethiopia,ETH,32,52,34,166,6,0,290,37,79,41,211,10,0,378,668
2022,Uganda,UGA,Ethiopia,ETH,0,5,0,5,0,0,10,0,0,6,0,0,0,6,16
2022,Yemen,YEM,Ethiopia,ETH,64,136,145,647,81,0,1073,49,162,151,971,71,0,1404,2477
2022,Afghanistan,AFG,Fiji,FJI,0,0,8,5,0,0,13,0,0,0,0,0,0,0,13
2022,Tonga,TON,Fiji,FJI,0,0,5,0,0,0,5,0,0,0,0,0,0,0,5
2022,Afghanistan,AFG,Finland,FIN,0,0,0,0,0,94,94,0,0,0,0,0,316,316,4265
2022,Albania,ALB,Finland,FIN,0,0,0,0,0,13,13,0,0,0,0,0,11,11,30
2022,Algeria,DZA,Finland,FIN,0,0,0,0,0,0,0,0,0,0,0,0,0,0,23
2022,Angola,AGO,Finland,FIN,0,0,0,0,0,6,6,0,0,0,0,0,6,6,57
2022,Egypt,EGY,Finland,FIN,0,0,0,0,0,6,6,0,0,0,0,0,16,16,67
2022,Armenia,ARM,Finland,FIN,0,0,0,0,0,0,0,0,0,0,0,0,0,0,5
2022,Azerbaijan,AZE,Finland,FIN,0,0,0,0,0,0,0,0,0,0,0,0,0,0,95
2022,Burundi,BDI,Finland,FIN,0,0,0,0,0,0,0,0,0,0,0,0,0,0,7
2022,Bangladesh,BGD,Finland,FIN,0,0,0,0,0,0,0,0,0,0,0,0,0,0,38
2022,Burkina Faso,BFA,Finland,FIN,0,0,0,0,0,0,0,0,0,0,0,0,0,0,5
2022,Belarus,BLR,Finland,FIN,0,0,0,0,0,12,12,0,0,0,0,0,22,22,66
2022,Brazil,BRA,Finland,FIN,0,0,0,0,0,0,0,0,0,0,0,0,0,0,10
2022,Bosnia and Herzegovina,BIH,Finland,FIN,0,0,0,0,0,0,0,0,0,0,0,0,0,0,5
2022,Cambodia,KHM,Finland,FIN,0,0,0,0,0,0,0,0,0,0,0,0,0,0,10
2022,Central African Rep.,CAF,Finland,FIN,0,0,0,0,0,0,0,0,0,0,0,0,0,0,6
2022,China,CHN,Finland,FIN,0,0,0,0,0,11,11,0,0,0,0,0,9,9,195
2022,Cameroon,CMR,Finland,FIN,0,0,0,0,0,29,29,0,0,0,0,0,43,43,230
2022,Congo,COG,Finland,FIN,0,0,0,0,0,0,0,0,0,0,0,0,0,0,11
2022,Dem. Rep. of the Congo,COD,Finland,FIN,0,0,0,0,0,14,14,0,0,0,0,0,23,23,125
2022,Colombia,COL,Finland,FIN,0,0,0,0,0,21,21,0,0,0,0,0,26,26,53
2022,Cuba,CUB,Finland,FIN,0,0,0,0,0,21,21,0,0,0,0,0,15,15,41
2022,Dominica,DMA,Finland,FIN,0,0,0,0,0,0,0,0,0,0,0,0,0,0,5
2022,Dominican Rep.,DOM,Finland,FIN,0,0,0,0,0,0,0,0,0,0,0,0,0,0,5
2022,Ecuador,ECU,Finland,FIN,0,0,0,0,0,0,0,0,0,0,0,0,0,0,5
2022,Eritrea,ERI,Finland,FIN,0,0,0,0,0,9,9,0,0,0,0,0,0,0,878
2022,Ethiopia,ETH,Finland,FIN,0,0,0,0,0,22,22,0,0,0,0,0,36,36,215
2022,Gambia,GMB,Finland,FIN,0,0,0,0,0,6,6,0,0,0,0,0,28,28,62
2022,United Kingdom of Great Britain and Northern Ireland,GBR,Finland,FIN,0,0,0,0,0,7,7,0,0,0,0,0,0,0,7
2022,Georgia,GEO,Finland,FIN,0,0,0,0,0,25,25,0,0,0,0,0,48,48,82
2022,Ghana,GHA,Finland,FIN,0,0,0,0,0,6,6,0,0,0,0,0,17,17,58
2022,Guinea,GIN,Finland,FIN,0,0,0,0,0,7,7,0,0,0,0,0,0,0,32
2022,Honduras,HND,Finland,FIN,0,0,0,0,0,16,16,0,0,0,0,0,10,10,62
2022,Cote d'Ivoire,CIV,Finland,FIN,0,0,0,0,0,0,0,0,0,0,0,0,0,0,17
2022,India,IND,Finland,FIN,0,0,0,0,0,0,0,0,0,0,0,0,0,0,12
2022,Indonesia,IDN,Finland,FIN,0,0,0,0,0,0,0,0,0,0,0,0,0,0,5
2022,Iran (Islamic Rep. of),IRN,Finland,FIN,0,0,0,0,0,73,73,0,0,0,0,0,139,139,1148
2022,Iraq,IRQ,Finland,FIN,0,0,0,0,0,285,285,0,0,0,0,0,1017,1017,10439
2022,Jordan,JOR,Finland,FIN,0,0,0,0,0,0,0,0,0,0,0,0,0,0,14
2022,Kazakhstan,KAZ,Finland,FIN,0,0,0,0,0,0,0,0,0,0,0,0,0,0,19
2022,Kenya,KEN,Finland,FIN,0,0,0,0,0,7,7,0,0,0,0,0,6,6,31
2022,Kyrgyzstan,KGZ,Finland,FIN,0,0,0,0,0,0,0,0,0,0,0,0,0,0,22
2022,Liberia,LBR,Finland,FIN,0,0,0,0,0,0,0,0,0,0,0,0,0,0,5
2022,Libya,LBY,Finland,FIN,0,0,0,0,0,7,7,0,0,0,0,0,0,0,39
2022,Lebanon,LBN,Finland,FIN,0,0,0,0,0,0,0,0,0,0,0,0,0,0,17
2022,Sri Lanka,LKA,Finland,FIN,0,0,0,0,0,32,32,0,0,0,0,0,37,37,99
2022,Lithuania,LTU,Finland,FIN,0,0,0,0,0,0,0,0,0,0,0,0,0,0,5
2022,Rep. of Moldova,MDA,Finland,FIN,0,0,0,0,0,5,5,0,0,0,0,0,5,5,33
2022,Mexico,MEX,Finland,FIN,0,0,0,0,0,0,0,0,0,0,0,0,0,0,5
2022,Mali,MLI,Finland,FIN,0,0,0,0,0,0,0,0,0,0,0,0,0,0,8
2022,Malaysia,MYS,Finland,FIN,0,0,0,0,0,0,0,0,0,0,0,0,0,0,5
2022,Morocco,MAR,Finland,FIN,0,0,0,0,0,7,7,0,0,0,0,0,24,24,74
2022,Myanmar,MMR,Finland,FIN,0,0,0,0,0,9,9,0,0,0,0,0,0,0,40
2022,Nepal,NPL,Finland,FIN,0,0,0,0,0,0,0,0,0,0,0,0,0,0,5
2022,Niger,NER,Finland,FIN,0,0,0,0,0,0,0,0,0,0,0,0,0,0,5
2022,Nicaragua,NIC,Finland,FIN,0,0,0,0,0,35,35,0,0,0,0,0,39,39,186
2022,Nigeria,NGA,Finland,FIN,0,0,0,0,0,63,63,0,0,0,0,0,98,98,324
2022,Pakistan,PAK,Finland,FIN,0,0,0,0,0,16,16,0,0,0,0,0,35,35,135
2022,Peru,PER,Finland,FIN,0,0,0,0,0,0,0,0,0,0,0,0,0,0,5
2022,Russian Federation,RUS,Finland,FIN,0,0,0,0,0,495,495,0,0,0,0,0,785,785,2260
2022,Rwanda,RWA,Finland,FIN,0,0,0,0,0,31,31,0,0,0,0,0,31,31,110
2022,El Salvador,SLV,Finland,FIN,0,0,0,0,0,9,9,0,0,0,0,0,8,8,27
2022,Senegal,SEN,Finland,FIN,0,0,0,0,0,0,0,0,0,0,0,0,0,0,5
2022,Sierra Leone,SLE,Finland,FIN,0,0,0,0,0,7,7,0,0,0,0,0,11,11,23
2022,Somalia,SOM,Finland,FIN,0,0,0,0,0,152,152,0,0,0,0,0,313,313,2944
2022,Serbia and Kosovo: S/RES/1244 (1999),SRB,Finland,FIN,0,0,0,0,0,0,0,0,0,0,0,0,0,0,36
2022,Viet Nam,VNM,Finland,FIN,0,0,0,0,0,0,0,0,0,0,0,0,0,0,17
2022,South Sudan,SSD,Finland,FIN,0,0,0,0,0,0,0,0,0,0,0,0,0,0,8
2022,Stateless,XXA,Finland,FIN,0,0,0,0,0,11,11,0,0,0,0,0,19,19,433
2022,Sudan,SDN,Finland,FIN,0,0,0,0,0,0,0,0,0,0,0,0,0,0,62
2022,Syrian Arab Rep.,SYR,Finland,FIN,0,0,0,0,0,36,36,0,0,0,0,0,118,118,2748
2022,United Rep. of Tanzania,TZA,Finland,FIN,0,0,0,0,0,0,0,0,0,0,0,0,0,0,13
2022,Tajikistan,TJK,Finland,FIN,0,0,0,0,0,0,0,0,0,0,0,0,0,0,15
2022,Turkmenistan,TKM,Finland,FIN,0,0,0,0,0,0,0,0,0,0,0,0,0,0,5
2022,Togo,TGO,Finland,FIN,0,0,0,0,0,0,0,0,0,0,0,0,0,0,5
2022,Tunisia,TUN,Finland,FIN,0,0,0,0,0,0,0,0,0,0,0,0,0,0,15
2022,Türkiye,TUR,Finland,FIN,0,0,0,0,0,72,72,0,0,0,0,0,149,149,1179
2022,Uganda,UGA,Finland,FIN,0,0,0,0,0,14,14,0,0,0,0,0,5,5,59
2022,Unknown ,UNK,Finland,FIN,0,0,0,0,0,0,0,0,0,0,0,0,0,0,239
2022,Ukraine,UKR,Finland,FIN,0,0,0,0,0,28669,28669,0,0,0,0,0,16823,16823,45506
2022,United States of America,USA,Finland,FIN,0,0,0,0,0,0,0,0,0,0,0,0,0,0,7
2022,Uzbekistan,UZB,Finland,FIN,0,0,0,0,0,7,7,0,0,0,0,0,5,5,31
2022,Venezuela (Bolivarian Republic of),VEN,Finland,FIN,0,0,0,0,0,12,12,0,0,0,0,0,5,5,22
2022,Yemen,YEM,Finland,FIN,0,0,0,0,0,11,11,0,0,0,0,0,30,30,372
2022,Zimbabwe,ZWE,Finland,FIN,0,0,0,0,0,0,0,0,0,0,0,0,0,0,6
2022,Afghanistan,AFG,France,FRA,0,0,0,0,0,10220,10220,0,0,0,0,0,53286,53286,74636
2022,Albania,ALB,France,FRA,0,0,0,0,0,5635,5635,0,0,0,0,0,5209,5209,13371
2022,Algeria,DZA,France,FRA,0,0,0,0,0,1525,1525,0,0,0,0,0,1742,1742,3742
2022,Angola,AGO,France,FRA,0,0,0,0,0,3345,3345,0,0,0,0,0,3656,3656,7439
2022,Egypt,EGY,France,FRA,0,0,0,0,0,541,541,0,0,0,0,0,1228,1228,2337
2022,Argentina,ARG,France,FRA,0,0,0,0,0,11,11,0,0,0,0,0,7,7,23
2022,Armenia,ARM,France,FRA,0,0,0,0,0,3148,3148,0,0,0,0,0,3232,3232,7592
2022,Azerbaijan,AZE,France,FRA,0,0,0,0,0,2292,2292,0,0,0,0,0,2387,2387,5092
2022,Bahrain,BHR,France,FRA,0,0,0,0,0,11,11,0,0,0,0,0,11,11,22
2022,Burundi,BDI,France,FRA,0,0,0,0,0,910,910,0,0,0,0,0,1163,1163,2308
2022,Benin,BEN,France,FRA,0,0,0,0,0,124,124,0,0,0,0,0,137,137,423
2022,Bangladesh,BGD,France,FRA,0,0,0,0,0,2012,2012,0,0,0,0,0,7561,7561,15680
2022,Bhutan,BTN,France,FRA,0,0,0,0,0,37,37,0,0,0,0,0,133,133,176
2022,Burkina Faso,BFA,France,FRA,0,0,0,0,0,414,414,0,0,0,0,0,276,276,986
2022,Belarus,BLR,France,FRA,0,0,0,0,0,431,431,0,0,0,0,0,470,470,1033
2022,Bolivia (Plurinational State of),BOL,France,FRA,0,0,0,0,0,42,42,0,0,0,0,0,28,28,75
2022,Brazil,BRA,France,FRA,0,0,0,0,0,39,39,0,0,0,0,0,50,50,216
2022,Bosnia and Herzegovina,BIH,France,FRA,0,0,0,0,0,3332,3332,0,0,0,0,0,3572,3572,7041
2022,Bulgaria,BGR,France,FRA,0,0,0,0,0,28,28,0,0,0,0,0,38,38,66
2022,Cambodia,KHM,France,FRA,0,0,0,0,0,5244,5244,0,0,0,0,0,5551,5551,10824
2022,Central African Rep.,CAF,France,FRA,0,0,0,0,0,2854,2854,0,0,0,0,0,2807,2807,5946
2022,Chad,TCD,France,FRA,0,0,0,0,0,1293,1293,0,0,0,0,0,2098,2098,4343
2022,China,CHN,France,FRA,0,0,0,0,0,4799,4799,0,0,0,0,0,6362,6362,11430
2022,Chile,CHL,France,FRA,0,0,0,0,0,77,77,0,0,0,0,0,76,76,164
2022,Cameroon,CMR,France,FRA,0,0,0,0,0,1257,1257,0,0,0,0,0,1724,1724,4035
2022,Congo,COG,France,FRA,0,0,0,0,0,2838,2838,0,0,0,0,0,2969,2969,6663
2022,Dem. Rep. of the Congo,COD,France,FRA,0,0,0,0,0,16228,16228,0,0,0,0,0,16535,16535,36300
2022,Comoros,COM,France,FRA,0,0,0,0,0,757,757,0,0,0,0,0,1115,1115,2554
2022,Colombia,COL,France,FRA,0,0,0,0,0,698,698,0,0,0,0,0,729,729,2290
2022,Cuba,CUB,France,FRA,0,0,0,0,0,151,151,0,0,0,0,0,243,243,550
2022,Cabo Verde,CPV,France,FRA,0,0,0,0,0,5,5,0,0,0,0,0,0,0,10
2022,Djibouti,DJI,France,FRA,0,0,0,0,0,354,354,0,0,0,0,0,309,309,908
2022,Dominica,DMA,France,FRA,0,0,0,0,0,6,6,0,0,0,0,0,5,5,11
2022,Dominican Rep.,DOM,France,FRA,0,0,0,0,0,127,127,0,0,0,0,0,75,75,307
2022,Ecuador,ECU,France,FRA,0,0,0,0,0,14,14,0,0,0,0,0,23,23,42
2022,Equatorial Guinea,GNQ,France,FRA,0,0,0,0,0,43,43,0,0,0,0,0,33,33,81
2022,Eritrea,ERI,France,FRA,0,0,0,0,0,4193,4193,0,0,0,0,0,7794,7794,12466
2022,Ethiopia,ETH,France,FRA,0,0,0,0,0,1531,1531,0,0,0,0,0,1947,1947,3879
2022,Gabon,GAB,France,FRA,0,0,0,0,0,335,335,0,0,0,0,0,253,253,768
2022,Gambia,GMB,France,FRA,0,0,0,0,0,320,320,0,0,0,0,0,274,274,708
2022,Palestinian,PSE,France,FRA,0,0,0,0,0,896,896,0,0,0,0,0,1203,1203,2196
2022,Georgia,GEO,France,FRA,0,0,0,0,0,3277,3277,0,0,0,0,0,2900,2900,10143
2022,Ghana,GHA,France,FRA,0,0,0,0,0,236,236,0,0,0,0,0,375,375,674
2022,Guinea-Bissau,GNB,France,FRA,0,0,0,0,0,519,519,0,0,0,0,0,781,781,1371
2022,Guatemala,GTM,France,FRA,0,0,0,0,0,14,14,0,0,0,0,0,11,11,30
2022,Guinea,GIN,France,FRA,0,0,0,0,0,12673,12673,0,0,0,0,0,9612,9612,25029
2022,Guyana,GUY,France,FRA,0,0,0,0,0,14,14,0,0,0,0,0,24,24,38
2022,Haiti,HTI,France,FRA,0,0,0,0,0,3413,3413,0,0,0,0,0,3826,3826,8045
2022,Honduras,HND,France,FRA,0,0,0,0,0,35,35,0,0,0,0,0,25,25,65
2022,Croatia,HRV,France,FRA,0,0,0,0,0,31,31,0,0,0,0,0,30,30,61
2022,Hungary,HUN,France,FRA,0,0,0,0,0,24,24,0,0,0,0,0,45,45,74
2022,Cote d'Ivoire,CIV,France,FRA,0,0,0,0,0,9451,9451,0,0,0,0,0,4299,4299,16772
2022,India,IND,France,FRA,0,0,0,0,0,118,118,0,0,0,0,0,211,211,529
2022,Indonesia,IDN,France,FRA,0,0,0,0,0,5,5,0,0,0,0,0,5,5,18
2022,Iran (Islamic Rep. of),IRN,France,FRA,0,0,0,0,0,1643,1643,0,0,0,0,0,2542,2542,4541
2022,Iraq,IRQ,France,FRA,0,0,0,0,0,6580,6580,0,0,0,0,0,7494,7494,14295
2022,Israel,ISR,France,FRA,0,0,0,0,0,9,9,0,0,0,0,0,0,0,9
2022,Italy,ITA,France,FRA,0,0,0,0,0,0,0,0,0,0,0,0,7,7,7
2022,Jamaica,JAM,France,FRA,0,0,0,0,0,10,10,0,0,0,0,0,31,31,41
2022,Jordan,JOR,France,FRA,0,0,0,0,0,25,25,0,0,0,0,0,39,39,78
2022,Kazakhstan,KAZ,France,FRA,0,0,0,0,0,564,564,0,0,0,0,0,524,524,1191
2022,Kenya,KEN,France,FRA,0,0,0,0,0,121,121,0,0,0,0,0,87,87,247
2022,Kyrgyzstan,KGZ,France,FRA,0,0,0,0,0,262,262,0,0,0,0,0,272,272,560
2022,Kuwait,KWT,France,FRA,0,0,0,0,0,266,266,0,0,0,0,0,394,394,707
2022,Lao People's Dem. Rep.,LAO,France,FRA,0,0,0,0,0,2935,2935,0,0,0,0,0,3421,3421,6356
2022,Liberia,LBR,France,FRA,0,0,0,0,0,131,131,0,0,0,0,0,236,236,409
2022,Libya,LBY,France,FRA,0,0,0,0,0,885,885,0,0,0,0,0,1545,1545,2578
2022,Saint Lucia,LCA,France,FRA,0,0,0,0,0,5,5,0,0,0,0,0,5,5,18
2022,Lebanon,LBN,France,FRA,0,0,0,0,0,159,159,0,0,0,0,0,240,240,527
2022,Sri Lanka,LKA,France,FRA,0,0,0,0,0,12557,12557,0,0,0,0,0,21164,21164,35153
2022,Latvia,LVA,France,FRA,0,0,0,0,0,17,17,0,0,0,0,0,21,21,38
2022,Madagascar,MDG,France,FRA,0,0,0,0,0,251,251,0,0,0,0,0,206,206,941
2022,Mauritania,MRT,France,FRA,0,0,0,0,0,2475,2475,0,0,0,0,0,5823,5823,9237
2022,North Macedonia,MKD,France,FRA,0,0,0,0,0,415,415,0,0,0,0,0,352,352,983
2022,Rep. of Moldova,MDA,France,FRA,0,0,0,0,0,230,230,0,0,0,0,0,234,234,579
2022,Maldives,MDV,France,FRA,0,0,0,0,0,5,5,0,0,0,0,0,0,0,5
2022,Mexico,MEX,France,FRA,0,0,0,0,0,15,15,0,0,0,0,0,21,21,51
2022,Mali,MLI,France,FRA,0,0,0,0,0,5805,5805,0,0,0,0,0,2631,2631,9526
2022,Malaysia,MYS,France,FRA,0,0,0,0,0,13,13,0,0,0,0,0,14,14,27
2022,Montenegro,MNE,France,FRA,0,0,0,0,0,105,105,0,0,0,0,0,102,102,234
2022,Mongolia,MNG,France,FRA,0,0,0,0,0,456,456,0,0,0,0,0,394,394,919
2022,Morocco,MAR,France,FRA,0,0,0,0,0,508,508,0,0,0,0,0,909,909,1685
2022,Mozambique,MOZ,France,FRA,0,0,0,0,0,7,7,0,0,0,0,0,9,9,16
2022,Mauritius,MUS,France,FRA,0,0,0,0,0,35,35,0,0,0,0,0,34,34,74
2022,Myanmar,MMR,France,FRA,0,0,0,0,0,67,67,0,0,0,0,0,311,311,412
2022,Nepal,NPL,France,FRA,0,0,0,0,0,93,93,0,0,0,0,0,121,121,340
2022,Niger,NER,France,FRA,0,0,0,0,0,77,77,0,0,0,0,0,172,172,336
2022,Nicaragua,NIC,France,FRA,0,0,0,0,0,52,52,0,0,0,0,0,44,44,126
2022,Nigeria,NGA,France,FRA,0,0,0,0,0,4533,4533,0,0,0,0,0,2504,2504,9140
2022,Pakistan,PAK,France,FRA,0,0,0,0,0,659,659,0,0,0,0,0,2376,2376,4462
2022,Paraguay,PRY,France,FRA,0,0,0,0,0,5,5,0,0,0,0,0,5,5,10
2022,Peru,PER,France,FRA,0,0,0,0,0,266,266,0,0,0,0,0,270,270,700
2022,Philippines,PHL,France,FRA,0,0,0,0,0,8,8,0,0,0,0,0,5,5,19
2022,Poland,POL,France,FRA,0,0,0,0,0,47,47,0,0,0,0,0,63,63,110
2022,Romania,ROU,France,FRA,0,0,0,0,0,66,66,0,0,0,0,0,91,91,157
2022,South Africa,ZAF,France,FRA,0,0,0,0,0,79,79,0,0,0,0,0,84,84,176
2022,Russian Federation,RUS,France,FRA,0,0,0,0,0,17039,17039,0,0,0,0,0,16829,16829,36053
2022,Rwanda,RWA,France,FRA,0,0,0,0,0,2329,2329,0,0,0,0,0,2235,2235,4951
2022,El Salvador,SLV,France,FRA,0,0,0,0,0,71,71,0,0,0,0,0,55,55,148
2022,Saudi Arabia,SAU,France,FRA,0,0,0,0,0,30,30,0,0,0,0,0,21,21,51
2022,Senegal,SEN,France,FRA,0,0,0,0,0,1895,1895,0,0,0,0,0,1280,1280,3861
2022,Sierra Leone,SLE,France,FRA,0,0,0,0,0,539,539,0,0,0,0,0,786,786,1580
2022,Somalia,SOM,France,FRA,0,0,0,0,0,4162,4162,0,0,0,0,0,7404,7404,14194
2022,Spain,ESP,France,FRA,0,0,0,0,0,0,0,0,0,0,0,0,5,5,5
2022,Serbia and Kosovo: S/RES/1244 (1999),SRB,France,FRA,0,0,0,0,0,8961,8961,0,0,0,0,0,9141,9141,19004
2022,Viet Nam,VNM,France,FRA,0,0,0,0,0,3432,3432,0,0,0,0,0,4431,4431,7883
2022,South Sudan,SSD,France,FRA,0,0,0,0,0,71,71,0,0,0,0,0,196,196,312
2022,Stateless,XXA,France,FRA,0,0,0,0,0,603,603,0,0,0,0,0,1196,1196,2185
2022,Sao Tome and Principe,STP,France,FRA,0,0,0,0,0,5,5,0,0,0,0,0,0,0,5
2022,Sudan,SDN,France,FRA,0,0,0,0,0,3686,3686,0,0,0,0,0,21293,21293,26103
2022,Suriname,SUR,France,FRA,0,0,0,0,0,8,8,0,0,0,0,0,6,6,24
2022,Slovakia,SVK,France,FRA,0,0,0,0,0,69,69,0,0,0,0,0,61,61,130
2022,Syrian Arab Rep.,SYR,France,FRA,0,0,0,0,0,18692,18692,0,0,0,0,0,21647,21647,41331
2022,United Rep. of Tanzania,TZA,France,FRA,0,0,0,0,0,14,14,0,0,0,0,0,18,18,52
2022,Thailand,THA,France,FRA,0,0,0,0,0,7,7,0,0,0,0,0,11,11,29
2022,Tajikistan,TJK,France,FRA,0,0,0,0,0,75,75,0,0,0,0,0,92,92,219
2022,Turkmenistan,TKM,France,FRA,0,0,0,0,0,21,21,0,0,0,0,0,27,27,53
2022,Togo,TGO,France,FRA,0,0,0,0,0,422,422,0,0,0,0,0,735,735,1296
2022,Tunisia,TUN,France,FRA,0,0,0,0,0,233,233,0,0,0,0,0,370,370,826
2022,Türkiye,TUR,France,FRA,0,0,0,0,0,5027,5027,0,0,0,0,0,13293,13293,26112
2022,Uganda,UGA,France,FRA,0,0,0,0,0,99,99,0,0,0,0,0,125,125,259
2022,Unknown ,UNK,France,FRA,0,0,0,0,0,3300,3300,0,0,0,0,0,3951,3951,7309
2022,Ukraine,UKR,France,FRA,0,0,0,0,0,49760,49760,0,0,0,0,0,19542,19542,70572
2022,United States of America,USA,France,FRA,0,0,0,0,0,5,5,0,0,0,0,0,5,5,16
2022,Uzbekistan,UZB,France,FRA,0,0,0,0,0,162,162,0,0,0,0,0,131,131,323
2022,Venezuela (Bolivarian Republic of),VEN,France,FRA,0,0,0,0,0,893,893,0,0,0,0,0,788,788,2192
2022,Western Sahara,ESH,France,FRA,0,0,0,0,0,198,198,0,0,0,0,0,664,664,1001
2022,Yemen,YEM,France,FRA,0,0,0,0,0,343,343,0,0,0,0,0,741,741,1211
2022,Zimbabwe,ZWE,France,FRA,0,0,0,0,0,40,40,0,0,0,0,0,44,44,89
2022,Burundi,BDI,Gabon,GAB,0,0,0,5,0,0,5,0,0,0,0,0,0,0,5
2022,Central African Rep.,CAF,Gabon,GAB,0,0,0,0,0,0,0,0,5,0,23,0,0,28,28
2022,Chad,TCD,Gabon,GAB,0,0,5,15,0,0,20,0,5,5,32,0,0,42,62
2022,Cameroon,CMR,Gabon,GAB,0,0,0,0,0,0,0,0,0,0,10,0,0,10,10
2022,Congo,COG,Gabon,GAB,0,0,5,19,0,0,24,0,0,6,29,0,0,35,59
2022,Dem. Rep. of the Congo,COD,Gabon,GAB,0,17,6,26,0,0,49,0,0,9,25,11,0,45,94
2022,Mauritania,MRT,Gabon,GAB,0,0,0,0,0,0,0,0,0,0,6,0,0,6,6
2022,Sao Tome and Principe,STP,Gabon,GAB,0,0,0,6,0,0,6,0,0,0,0,0,0,0,6
2022,Sudan,SDN,Gabon,GAB,0,0,0,0,0,0,0,0,0,0,5,0,0,5,5
2022,Togo,TGO,Gabon,GAB,0,0,0,0,0,0,0,0,0,0,5,0,0,5,5
2022,Central African Rep.,CAF,Gambia,GMB,0,5,0,0,0,0,5,0,0,0,0,0,0,0,5
2022,Congo,COG,Gambia,GMB,0,0,0,0,0,0,0,0,0,0,5,0,0,5,5
2022,Dem. Rep. of the Congo,COD,Gambia,GMB,0,5,0,17,5,0,27,0,5,7,10,0,0,22,49
2022,Guinea,GIN,Gambia,GMB,0,0,5,0,0,0,5,0,0,0,0,0,0,0,5
2022,Liberia,LBR,Gambia,GMB,0,0,5,5,0,0,10,0,5,0,0,0,0,5,15
2022,Senegal,SEN,Gambia,GMB,167,309,334,968,118,0,1896,198,354,338,763,143,0,1796,3692
2022,Sierra Leone,SLE,Gambia,GMB,0,11,7,37,0,0,55,5,5,8,26,0,0,44,99
2022,Togo,TGO,Gambia,GMB,0,0,0,5,0,0,5,0,0,0,8,0,0,8,13
2022,Afghanistan,AFG,United Kingdom of Great Britain and Northern Ireland,GBR,0,0,0,0,0,0,0,0,0,0,0,0,0,0,24321
2022,Albania,ALB,United Kingdom of Great Britain and Northern Ireland,GBR,0,0,0,0,0,0,0,0,0,0,0,0,0,0,29444
2022,Algeria,DZA,United Kingdom of Great Britain and Northern Ireland,GBR,0,0,0,0,0,0,0,0,0,0,0,0,0,0,1091
2022,Angola,AGO,United Kingdom of Great Britain and Northern Ireland,GBR,0,0,0,0,0,0,0,0,0,0,0,0,0,0,288
2022,Antigua and Barbuda,ATG,United Kingdom of Great Britain and Northern Ireland,GBR,0,0,0,0,0,0,0,0,0,0,0,0,0,0,23
2022,Egypt,EGY,United Kingdom of Great Britain and Northern Ireland,GBR,0,0,0,0,0,0,0,0,0,0,0,0,0,0,3116
2022,Argentina,ARG,United Kingdom of Great Britain and Northern Ireland,GBR,0,0,0,0,0,0,0,0,0,0,0,0,0,0,33
2022,Armenia,ARM,United Kingdom of Great Britain and Northern Ireland,GBR,0,0,0,0,0,0,0,0,0,0,0,0,0,0,71
2022,Australia,AUS,United Kingdom of Great Britain and Northern Ireland,GBR,0,0,0,0,0,0,0,0,0,0,0,0,0,0,11
2022,Azerbaijan,AZE,United Kingdom of Great Britain and Northern Ireland,GBR,0,0,0,0,0,0,0,0,0,0,0,0,0,0,257
2022,Bahrain,BHR,United Kingdom of Great Britain and Northern Ireland,GBR,0,0,0,0,0,0,0,0,0,0,0,0,0,0,121
2022,Barbados,BRB,United Kingdom of Great Britain and Northern Ireland,GBR,0,0,0,0,0,0,0,0,0,0,0,0,0,0,34
2022,Burundi,BDI,United Kingdom of Great Britain and Northern Ireland,GBR,0,0,0,0,0,0,0,0,0,0,0,0,0,0,81
2022,Benin,BEN,United Kingdom of Great Britain and Northern Ireland,GBR,0,0,0,0,0,0,0,0,0,0,0,0,0,0,45
2022,Bangladesh,BGD,United Kingdom of Great Britain and Northern Ireland,GBR,0,0,0,0,0,0,0,0,0,0,0,0,0,0,8347
2022,Bhutan,BTN,United Kingdom of Great Britain and Northern Ireland,GBR,0,0,0,0,0,0,0,0,0,0,0,0,0,0,15
2022,Burkina Faso,BFA,United Kingdom of Great Britain and Northern Ireland,GBR,0,0,0,0,0,0,0,0,0,0,0,0,0,0,46
2022,Belarus,BLR,United Kingdom of Great Britain and Northern Ireland,GBR,0,0,0,0,0,0,0,0,0,0,0,0,0,0,223
2022,Bolivia (Plurinational State of),BOL,United Kingdom of Great Britain and Northern Ireland,GBR,0,0,0,0,0,0,0,0,0,0,0,0,0,0,79
2022,Botswana,BWA,United Kingdom of Great Britain and Northern Ireland,GBR,0,0,0,0,0,0,0,0,0,0,0,0,0,0,287
2022,Brazil,BRA,United Kingdom of Great Britain and Northern Ireland,GBR,0,0,0,0,0,0,0,0,0,0,0,0,0,0,819
2022,Bosnia and Herzegovina,BIH,United Kingdom of Great Britain and Northern Ireland,GBR,0,0,0,0,0,0,0,0,0,0,0,0,0,0,10
2022,Bulgaria,BGR,United Kingdom of Great Britain and Northern Ireland,GBR,0,0,0,0,0,0,0,0,0,0,0,0,0,0,5
2022,Belize,BLZ,United Kingdom of Great Britain and Northern Ireland,GBR,0,0,0,0,0,0,0,0,0,0,0,0,0,0,5
2022,Canada,CAN,United Kingdom of Great Britain and Northern Ireland,GBR,0,0,0,0,0,0,0,0,0,0,0,0,0,0,47
2022,Central African Rep.,CAF,United Kingdom of Great Britain and Northern Ireland,GBR,0,0,0,0,0,0,0,0,0,0,0,0,0,0,30
2022,Chad,TCD,United Kingdom of Great Britain and Northern Ireland,GBR,0,0,0,0,0,0,0,0,0,0,0,0,0,0,572
2022,China,CHN,United Kingdom of Great Britain and Northern Ireland,GBR,0,0,0,0,0,0,0,0,0,0,0,0,0,0,3675
2022,Chile,CHL,United Kingdom of Great Britain and Northern Ireland,GBR,0,0,0,0,0,0,0,0,0,0,0,0,0,0,11
2022,Cameroon,CMR,United Kingdom of Great Britain and Northern Ireland,GBR,0,0,0,0,0,0,0,0,0,0,0,0,0,0,1317
2022,Congo,COG,United Kingdom of Great Britain and Northern Ireland,GBR,0,0,0,0,0,0,0,0,0,0,0,0,0,0,182
2022,Dem. Rep. of the Congo,COD,United Kingdom of Great Britain and Northern Ireland,GBR,0,0,0,0,0,0,0,0,0,0,0,0,0,0,1143
2022,Colombia,COL,United Kingdom of Great Britain and Northern Ireland,GBR,0,0,0,0,0,0,0,0,0,0,0,0,0,0,159
2022,Costa Rica,CRI,United Kingdom of Great Britain and Northern Ireland,GBR,0,0,0,0,0,0,0,0,0,0,0,0,0,0,13
2022,Cuba,CUB,United Kingdom of Great Britain and Northern Ireland,GBR,0,0,0,0,0,0,0,0,0,0,0,0,0,0,50
2022,Cabo Verde,CPV,United Kingdom of Great Britain and Northern Ireland,GBR,0,0,0,0,0,0,0,0,0,0,0,0,0,0,5
2022,Cyprus,CYP,United Kingdom of Great Britain and Northern Ireland,GBR,0,0,0,0,0,0,0,0,0,0,0,0,0,0,13
2022,Czechia,CZE,United Kingdom of Great Britain and Northern Ireland,GBR,0,0,0,0,0,0,0,0,0,0,0,0,0,0,7
2022,Djibouti,DJI,United Kingdom of Great Britain and Northern Ireland,GBR,0,0,0,0,0,0,0,0,0,0,0,0,0,0,12
2022,Dominica,DMA,United Kingdom of Great Britain and Northern Ireland,GBR,0,0,0,0,0,0,0,0,0,0,0,0,0,0,85
2022,Dominican Rep.,DOM,United Kingdom of Great Britain and Northern Ireland,GBR,0,0,0,0,0,0,0,0,0,0,0,0,0,0,5
2022,Ecuador,ECU,United Kingdom of Great Britain and Northern Ireland,GBR,0,0,0,0,0,0,0,0,0,0,0,0,0,0,58
2022,Equatorial Guinea,GNQ,United Kingdom of Great Britain and Northern Ireland,GBR,0,0,0,0,0,0,0,0,0,0,0,0,0,0,13
2022,Eritrea,ERI,United Kingdom of Great Britain and Northern Ireland,GBR,0,0,0,0,0,0,0,0,0,0,0,0,0,0,23735
2022,Ethiopia,ETH,United Kingdom of Great Britain and Northern Ireland,GBR,0,0,0,0,0,0,0,0,0,0,0,0,0,0,3903
2022,Gabon,GAB,United Kingdom of Great Britain and Northern Ireland,GBR,0,0,0,0,0,0,0,0,0,0,0,0,0,0,16
2022,Gambia,GMB,United Kingdom of Great Britain and Northern Ireland,GBR,0,0,0,0,0,0,0,0,0,0,0,0,0,0,1042
2022,Palestinian,PSE,United Kingdom of Great Britain and Northern Ireland,GBR,0,0,0,0,0,0,0,0,0,0,0,0,0,0,1272
2022,United Kingdom of Great Britain and Northern Ireland,GBR,United Kingdom of Great Britain and Northern Ireland,GBR,0,0,0,0,0,0,0,0,0,0,0,0,0,0,20
2022,Georgia,GEO,United Kingdom of Great Britain and Northern Ireland,GBR,0,0,0,0,0,0,0,0,0,0,0,0,0,0,1900
2022,Germany,DEU,United Kingdom of Great Britain and Northern Ireland,GBR,0,0,0,0,0,0,0,0,0,0,0,0,0,0,5
2022,Ghana,GHA,United Kingdom of Great Britain and Northern Ireland,GBR,0,0,0,0,0,0,0,0,0,0,0,0,0,0,808
2022,Guinea-Bissau,GNB,United Kingdom of Great Britain and Northern Ireland,GBR,0,0,0,0,0,0,0,0,0,0,0,0,0,0,14
2022,Greece,GRC,United Kingdom of Great Britain and Northern Ireland,GBR,0,0,0,0,0,0,0,0,0,0,0,0,0,0,18
2022,Grenada,GRD,United Kingdom of Great Britain and Northern Ireland,GBR,0,0,0,0,0,0,0,0,0,0,0,0,0,0,96
2022,Guatemala,GTM,United Kingdom of Great Britain and Northern Ireland,GBR,0,0,0,0,0,0,0,0,0,0,0,0,0,0,66
2022,Guinea,GIN,United Kingdom of Great Britain and Northern Ireland,GBR,0,0,0,0,0,0,0,0,0,0,0,0,0,0,364
2022,Guyana,GUY,United Kingdom of Great Britain and Northern Ireland,GBR,0,0,0,0,0,0,0,0,0,0,0,0,0,0,27
2022,Haiti,HTI,United Kingdom of Great Britain and Northern Ireland,GBR,0,0,0,0,0,0,0,0,0,0,0,0,0,0,11
2022,"China, Hong Kong SAR",HKG,United Kingdom of Great Britain and Northern Ireland,GBR,0,0,0,0,0,0,0,0,0,0,0,0,0,0,170
2022,Honduras,HND,United Kingdom of Great Britain and Northern Ireland,GBR,0,0,0,0,0,0,0,0,0,0,0,0,0,0,1806
2022,Hungary,HUN,United Kingdom of Great Britain and Northern Ireland,GBR,0,0,0,0,0,0,0,0,0,0,0,0,0,0,25
2022,Cote d'Ivoire,CIV,United Kingdom of Great Britain and Northern Ireland,GBR,0,0,0,0,0,0,0,0,0,0,0,0,0,0,300
2022,India,IND,United Kingdom of Great Britain and Northern Ireland,GBR,0,0,0,0,0,0,0,0,0,0,0,0,0,0,5157
2022,Indonesia,IDN,United Kingdom of Great Britain and Northern Ireland,GBR,0,0,0,0,0,0,0,0,0,0,0,0,0,0,223
2022,Iran (Islamic Rep. of),IRN,United Kingdom of Great Britain and Northern Ireland,GBR,0,0,0,0,0,0,0,0,0,0,0,0,0,0,41300
2022,Iraq,IRQ,United Kingdom of Great Britain and Northern Ireland,GBR,0,0,0,0,0,0,0,0,0,0,0,0,0,0,24159
2022,Israel,ISR,United Kingdom of Great Britain and Northern Ireland,GBR,0,0,0,0,0,0,0,0,0,0,0,0,0,0,157
2022,Italy,ITA,United Kingdom of Great Britain and Northern Ireland,GBR,0,0,0,0,0,0,0,0,0,0,0,0,0,0,10
2022,Jamaica,JAM,United Kingdom of Great Britain and Northern Ireland,GBR,0,0,0,0,0,0,0,0,0,0,0,0,0,0,442
2022,Jordan,JOR,United Kingdom of Great Britain and Northern Ireland,GBR,0,0,0,0,0,0,0,0,0,0,0,0,0,0,238
2022,Japan,JPN,United Kingdom of Great Britain and Northern Ireland,GBR,0,0,0,0,0,0,0,0,0,0,0,0,0,0,9
2022,Kazakhstan,KAZ,United Kingdom of Great Britain and Northern Ireland,GBR,0,0,0,0,0,0,0,0,0,0,0,0,0,0,205
2022,Kenya,KEN,United Kingdom of Great Britain and Northern Ireland,GBR,0,0,0,0,0,0,0,0,0,0,0,0,0,0,727
2022,Kyrgyzstan,KGZ,United Kingdom of Great Britain and Northern Ireland,GBR,0,0,0,0,0,0,0,0,0,0,0,0,0,0,178
2022,Rep. of Korea,KOR,United Kingdom of Great Britain and Northern Ireland,GBR,0,0,0,0,0,0,0,0,0,0,0,0,0,0,16
2022,Dem. People's Rep. of Korea,PRK,United Kingdom of Great Britain and Northern Ireland,GBR,0,0,0,0,0,0,0,0,0,0,0,0,0,0,49
2022,Kuwait,KWT,United Kingdom of Great Britain and Northern Ireland,GBR,0,0,0,0,0,0,0,0,0,0,0,0,0,0,2209
2022,Lao People's Dem. Rep.,LAO,United Kingdom of Great Britain and Northern Ireland,GBR,0,0,0,0,0,0,0,0,0,0,0,0,0,0,5
2022,Liberia,LBR,United Kingdom of Great Britain and Northern Ireland,GBR,0,0,0,0,0,0,0,0,0,0,0,0,0,0,58
2022,Libya,LBY,United Kingdom of Great Britain and Northern Ireland,GBR,0,0,0,0,0,0,0,0,0,0,0,0,0,0,5817
2022,Saint Lucia,LCA,United Kingdom of Great Britain and Northern Ireland,GBR,0,0,0,0,0,0,0,0,0,0,0,0,0,0,94
2022,Lebanon,LBN,United Kingdom of Great Britain and Northern Ireland,GBR,0,0,0,0,0,0,0,0,0,0,0,0,0,0,441
2022,Sri Lanka,LKA,United Kingdom of Great Britain and Northern Ireland,GBR,0,0,0,0,0,0,0,0,0,0,0,0,0,0,6381
2022,Lithuania,LTU,United Kingdom of Great Britain and Northern Ireland,GBR,0,0,0,0,0,0,0,0,0,0,0,0,0,0,14
2022,Latvia,LVA,United Kingdom of Great Britain and Northern Ireland,GBR,0,0,0,0,0,0,0,0,0,0,0,0,0,0,5
2022,"China, Macao SAR",MAC,United Kingdom of Great Britain and Northern Ireland,GBR,0,0,0,0,0,0,0,0,0,0,0,0,0,0,5
2022,Mauritania,MRT,United Kingdom of Great Britain and Northern Ireland,GBR,0,0,0,0,0,0,0,0,0,0,0,0,0,0,18
2022,North Macedonia,MKD,United Kingdom of Great Britain and Northern Ireland,GBR,0,0,0,0,0,0,0,0,0,0,0,0,0,0,32
2022,Rep. of Moldova,MDA,United Kingdom of Great Britain and Northern Ireland,GBR,0,0,0,0,0,0,0,0,0,0,0,0,0,0,20
2022,Maldives,MDV,United Kingdom of Great Britain and Northern Ireland,GBR,0,0,0,0,0,0,0,0,0,0,0,0,0,0,50
2022,Mexico,MEX,United Kingdom of Great Britain and Northern Ireland,GBR,0,0,0,0,0,0,0,0,0,0,0,0,0,0,118
2022,Mali,MLI,United Kingdom of Great Britain and Northern Ireland,GBR,0,0,0,0,0,0,0,0,0,0,0,0,0,0,113
2022,Malaysia,MYS,United Kingdom of Great Britain and Northern Ireland,GBR,0,0,0,0,0,0,0,0,0,0,0,0,0,0,939
2022,Malawi,MWI,United Kingdom of Great Britain and Northern Ireland,GBR,0,0,0,0,0,0,0,0,0,0,0,0,0,0,332
2022,Montenegro,MNE,United Kingdom of Great Britain and Northern Ireland,GBR,0,0,0,0,0,0,0,0,0,0,0,0,0,0,5
2022,Mongolia,MNG,United Kingdom of Great Britain and Northern Ireland,GBR,0,0,0,0,0,0,0,0,0,0,0,0,0,0,109
2022,Morocco,MAR,United Kingdom of Great Britain and Northern Ireland,GBR,0,0,0,0,0,0,0,0,0,0,0,0,0,0,720
2022,Mozambique,MOZ,United Kingdom of Great Britain and Northern Ireland,GBR,0,0,0,0,0,0,0,0,0,0,0,0,0,0,11
2022,Mauritius,MUS,United Kingdom of Great Britain and Northern Ireland,GBR,0,0,0,0,0,0,0,0,0,0,0,0,0,0,228
2022,Myanmar,MMR,United Kingdom of Great Britain and Northern Ireland,GBR,0,0,0,0,0,0,0,0,0,0,0,0,0,0,529
2022,Namibia,NAM,United Kingdom of Great Britain and Northern Ireland,GBR,0,0,0,0,0,0,0,0,0,0,0,0,0,0,1428
2022,Nepal,NPL,United Kingdom of Great Britain and Northern Ireland,GBR,0,0,0,0,0,0,0,0,0,0,0,0,0,0,1603
2022,Netherlands (Kingdom of the),NLD,United Kingdom of Great Britain and Northern Ireland,GBR,0,0,0,0,0,0,0,0,0,0,0,0,0,0,5
2022,Niger,NER,United Kingdom of Great Britain and Northern Ireland,GBR,0,0,0,0,0,0,0,0,0,0,0,0,0,0,221
2022,Nicaragua,NIC,United Kingdom of Great Britain and Northern Ireland,GBR,0,0,0,0,0,0,0,0,0,0,0,0,0,0,388
2022,Nigeria,NGA,United Kingdom of Great Britain and Northern Ireland,GBR,0,0,0,0,0,0,0,0,0,0,0,0,0,0,6572
2022,Norway,NOR,United Kingdom of Great Britain and Northern Ireland,GBR,0,0,0,0,0,0,0,0,0,0,0,0,0,0,5
2022,Oman,OMN,United Kingdom of Great Britain and Northern Ireland,GBR,0,0,0,0,0,0,0,0,0,0,0,0,0,0,64
2022,Pakistan,PAK,United Kingdom of Great Britain and Northern Ireland,GBR,0,0,0,0,0,0,0,0,0,0,0,0,0,0,13755
2022,Panama,PAN,United Kingdom of Great Britain and Northern Ireland,GBR,0,0,0,0,0,0,0,0,0,0,0,0,0,0,6
2022,Peru,PER,United Kingdom of Great Britain and Northern Ireland,GBR,0,0,0,0,0,0,0,0,0,0,0,0,0,0,18
2022,Philippines,PHL,United Kingdom of Great Britain and Northern Ireland,GBR,0,0,0,0,0,0,0,0,0,0,0,0,0,0,1139
2022,Poland,POL,United Kingdom of Great Britain and Northern Ireland,GBR,0,0,0,0,0,0,0,0,0,0,0,0,0,0,46
2022,Portugal,PRT,United Kingdom of Great Britain and Northern Ireland,GBR,0,0,0,0,0,0,0,0,0,0,0,0,0,0,5
2022,Qatar,QAT,United Kingdom of Great Britain and Northern Ireland,GBR,0,0,0,0,0,0,0,0,0,0,0,0,0,0,35
2022,Romania,ROU,United Kingdom of Great Britain and Northern Ireland,GBR,0,0,0,0,0,0,0,0,0,0,0,0,0,0,20
2022,South Africa,ZAF,United Kingdom of Great Britain and Northern Ireland,GBR,0,0,0,0,0,0,0,0,0,0,0,0,0,0,271
2022,Russian Federation,RUS,United Kingdom of Great Britain and Northern Ireland,GBR,0,0,0,0,0,0,0,0,0,0,0,0,0,0,2001
2022,Rwanda,RWA,United Kingdom of Great Britain and Northern Ireland,GBR,0,0,0,0,0,0,0,0,0,0,0,0,0,0,158
2022,El Salvador,SLV,United Kingdom of Great Britain and Northern Ireland,GBR,0,0,0,0,0,0,0,0,0,0,0,0,0,0,3877
2022,Saudi Arabia,SAU,United Kingdom of Great Britain and Northern Ireland,GBR,0,0,0,0,0,0,0,0,0,0,0,0,0,0,669
2022,Senegal,SEN,United Kingdom of Great Britain and Northern Ireland,GBR,0,0,0,0,0,0,0,0,0,0,0,0,0,0,177
2022,Seychelles,SYC,United Kingdom of Great Britain and Northern Ireland,GBR,0,0,0,0,0,0,0,0,0,0,0,0,0,0,9
2022,Singapore,SGP,United Kingdom of Great Britain and Northern Ireland,GBR,0,0,0,0,0,0,0,0,0,0,0,0,0,0,15
2022,Sierra Leone,SLE,United Kingdom of Great Britain and Northern Ireland,GBR,0,0,0,0,0,0,0,0,0,0,0,0,0,0,686
2022,Somalia,SOM,United Kingdom of Great Britain and Northern Ireland,GBR,0,0,0,0,0,0,0,0,0,0,0,0,0,0,3604
2022,Serbia and Kosovo: S/RES/1244 (1999),SRB,United Kingdom of Great Britain and Northern Ireland,GBR,0,0,0,0,0,0,0,0,0,0,0,0,0,0,168
2022,Viet Nam,VNM,United Kingdom of Great Britain and Northern Ireland,GBR,0,0,0,0,0,0,0,0,0,0,0,0,0,0,7067
2022,South Sudan,SSD,United Kingdom of Great Britain and Northern Ireland,GBR,0,0,0,0,0,0,0,0,0,0,0,0,0,0,365
2022,Stateless,XXA,United Kingdom of Great Britain and Northern Ireland,GBR,0,0,0,0,0,0,0,0,0,0,0,0,0,0,5077
2022,Saint Kitts and Nevis,KNA,United Kingdom of Great Britain and Northern Ireland,GBR,0,0,0,0,0,0,0,0,0,0,0,0,0,0,29
2022,Sudan,SDN,United Kingdom of Great Britain and Northern Ireland,GBR,0,0,0,0,0,0,0,0,0,0,0,0,0,0,17176
2022,Slovakia,SVK,United Kingdom of Great Britain and Northern Ireland,GBR,0,0,0,0,0,0,0,0,0,0,0,0,0,0,5
2022,Eswatini,SWZ,United Kingdom of Great Britain and Northern Ireland,GBR,0,0,0,0,0,0,0,0,0,0,0,0,0,0,56
2022,Sweden,SWE,United Kingdom of Great Britain and Northern Ireland,GBR,0,0,0,0,0,0,0,0,0,0,0,0,0,0,6
2022,Syrian Arab Rep.,SYR,United Kingdom of Great Britain and Northern Ireland,GBR,0,0,0,0,0,0,0,0,0,0,0,0,0,0,20054
2022,United Rep. of Tanzania,TZA,United Kingdom of Great Britain and Northern Ireland,GBR,0,0,0,0,0,0,0,0,0,0,0,0,0,0,228
2022,Thailand,THA,United Kingdom of Great Britain and Northern Ireland,GBR,0,0,0,0,0,0,0,0,0,0,0,0,0,0,246
2022,Tajikistan,TJK,United Kingdom of Great Britain and Northern Ireland,GBR,0,0,0,0,0,0,0,0,0,0,0,0,0,0,319
2022,Turkmenistan,TKM,United Kingdom of Great Britain and Northern Ireland,GBR,0,0,0,0,0,0,0,0,0,0,0,0,0,0,76
2022,Timor-Leste,TLS,United Kingdom of Great Britain and Northern Ireland,GBR,0,0,0,0,0,0,0,0,0,0,0,0,0,0,14
2022,Togo,TGO,United Kingdom of Great Britain and Northern Ireland,GBR,0,0,0,0,0,0,0,0,0,0,0,0,0,0,48
2022,Trinidad and Tobago,TTO,United Kingdom of Great Britain and Northern Ireland,GBR,0,0,0,0,0,0,0,0,0,0,0,0,0,0,331
2022,Tunisia,TUN,United Kingdom of Great Britain and Northern Ireland,GBR,0,0,0,0,0,0,0,0,0,0,0,0,0,0,290
2022,Türkiye,TUR,United Kingdom of Great Britain and Northern Ireland,GBR,0,0,0,0,0,0,0,0,0,0,0,0,0,0,6259
2022,United Arab Emirates,ARE,United Kingdom of Great Britain and Northern Ireland,GBR,0,0,0,0,0,0,0,0,0,0,0,0,0,0,43
2022,Uganda,UGA,United Kingdom of Great Britain and Northern Ireland,GBR,0,0,0,0,0,0,0,0,0,0,0,0,0,0,1435
2022,Unknown ,UNK,United Kingdom of Great Britain and Northern Ireland,GBR,0,0,0,0,0,0,0,0,0,0,0,0,0,0,9002
2022,Ukraine,UKR,United Kingdom of Great Britain and Northern Ireland,GBR,0,0,0,0,0,122074,122074,0,0,0,0,0,60126,60126,183399
2022,United States of America,USA,United Kingdom of Great Britain and Northern Ireland,GBR,0,0,0,0,0,0,0,0,0,0,0,0,0,0,214
2022,Uzbekistan,UZB,United Kingdom of Great Britain and Northern Ireland,GBR,0,0,0,0,0,0,0,0,0,0,0,0,0,0,451
2022,Vanuatu,VUT,United Kingdom of Great Britain and Northern Ireland,GBR,0,0,0,0,0,0,0,0,0,0,0,0,0,0,8
2022,Saint Vincent and the Grenadines,VCT,United Kingdom of Great Britain and Northern Ireland,GBR,0,0,0,0,0,0,0,0,0,0,0,0,0,0,98
2022,Venezuela (Bolivarian Republic of),VEN,United Kingdom of Great Britain and Northern Ireland,GBR,0,0,0,0,0,0,0,0,0,0,0,0,0,0,110
2022,Western Sahara,ESH,United Kingdom of Great Britain and Northern Ireland,GBR,0,0,0,0,0,0,0,0,0,0,0,0,0,0,16
2022,Yemen,YEM,United Kingdom of Great Britain and Northern Ireland,GBR,0,0,0,0,0,0,0,0,0,0,0,0,0,0,2585
2022,Zambia,ZMB,United Kingdom of Great Britain and Northern Ireland,GBR,0,0,0,0,0,0,0,0,0,0,0,0,0,0,144
2022,Zimbabwe,ZWE,United Kingdom of Great Britain and Northern Ireland,GBR,0,0,0,0,0,0,0,0,0,0,0,0,0,0,1292
2022,Afghanistan,AFG,Georgia,GEO,0,5,6,27,0,0,38,5,5,7,28,0,0,45,83
2022,Egypt,EGY,Georgia,GEO,0,5,8,29,0,0,42,0,7,7,51,0,0,65,107
2022,Bangladesh,BGD,Georgia,GEO,0,0,0,0,0,0,0,0,0,0,8,0,0,8,8
2022,Belarus,BLR,Georgia,GEO,0,7,0,0,0,0,7,0,0,0,8,0,0,8,15
2022,Dem. Rep. of the Congo,COD,Georgia,GEO,0,5,0,0,0,0,5,0,0,0,0,0,0,0,5
2022,Cuba,CUB,Georgia,GEO,0,0,0,0,0,0,0,0,0,0,5,0,0,5,5
2022,Eritrea,ERI,Georgia,GEO,0,0,0,10,0,0,10,0,0,5,5,0,0,10,20
2022,Ethiopia,ETH,Georgia,GEO,0,0,0,0,0,0,0,0,0,0,5,0,0,5,5
2022,Palestinian,PSE,Georgia,GEO,0,0,0,5,0,0,5,0,0,0,10,0,0,10,15
2022,Ghana,GHA,Georgia,GEO,0,0,0,0,0,0,0,0,0,0,5,0,0,5,5
2022,India,IND,Georgia,GEO,0,0,0,0,0,0,0,0,0,0,9,0,0,9,9
2022,Iran (Islamic Rep. of),IRN,Georgia,GEO,0,11,10,109,0,0,130,5,7,12,158,5,0,187,317
2022,Iraq,IRQ,Georgia,GEO,0,17,17,92,10,0,136,0,14,17,187,36,0,254,390
2022,Jordan,JOR,Georgia,GEO,0,0,0,0,0,0,0,0,5,0,18,0,0,23,23
2022,Kazakhstan,KAZ,Georgia,GEO,0,0,0,0,0,0,0,0,0,0,6,0,0,6,6
2022,Kyrgyzstan,KGZ,Georgia,GEO,0,0,0,5,0,0,5,0,0,0,0,0,0,0,5
2022,Lebanon,LBN,Georgia,GEO,0,0,6,13,0,0,19,0,0,5,22,0,0,27,46
2022,Morocco,MAR,Georgia,GEO,0,0,0,0,0,0,0,0,0,0,5,0,0,5,5
2022,Myanmar,MMR,Georgia,GEO,0,0,0,9,0,0,9,0,0,0,5,0,0,5,14
2022,Nigeria,NGA,Georgia,GEO,0,0,0,0,0,0,0,0,0,0,15,0,0,15,15
2022,Pakistan,PAK,Georgia,GEO,0,0,0,11,0,0,11,0,0,0,22,0,0,22,33
2022,South Africa,ZAF,Georgia,GEO,0,6,0,0,0,0,6,0,0,6,0,0,0,6,12
2022,Russian Federation,RUS,Georgia,GEO,0,17,14,115,5,0,151,0,16,24,130,13,0,183,334
2022,Somalia,SOM,Georgia,GEO,0,0,0,8,0,0,8,0,0,0,8,0,0,8,16
2022,Sudan,SDN,Georgia,GEO,0,0,6,0,0,0,6,0,0,0,0,0,0,0,6
2022,Syrian Arab Rep.,SYR,Georgia,GEO,14,14,21,116,30,0,195,12,28,24,178,31,0,273,468
2022,Thailand,THA,Georgia,GEO,0,0,0,5,0,0,5,0,0,0,0,0,0,0,5
2022,Tajikistan,TJK,Georgia,GEO,0,0,0,0,0,0,0,0,0,0,11,0,0,11,11
2022,Turkmenistan,TKM,Georgia,GEO,0,0,0,0,0,0,0,0,0,0,8,0,0,8,8
2022,Türkiye,TUR,Georgia,GEO,6,0,5,12,0,0,23,0,6,5,175,19,0,205,228
2022,Unknown ,UNK,Georgia,GEO,31,0,0,0,0,0,31,28,6,0,0,0,0,34,65
2022,Ukraine,UKR,Georgia,GEO,957,1395,900,10886,1588,0,15726,930,1554,914,6519,855,0,10772,26498
2022,Uzbekistan,UZB,Georgia,GEO,0,0,0,5,0,0,5,0,0,0,0,0,0,0,5
2022,Yemen,YEM,Georgia,GEO,0,0,8,21,0,0,29,0,0,10,43,0,0,53,82
2022,Afghanistan,AFG,Germany,DEU,6904,16234,10970,45584,4761,72,84525,7295,17565,15962,85805,4225,118,130970,215677
2022,Albania,ALB,Germany,DEU,127,246,201,936,45,0,1555,142,301,175,776,59,0,1453,3008
2022,Algeria,DZA,Germany,DEU,66,69,33,293,21,12,494,88,70,54,1196,40,120,1568,2062
2022,Angola,AGO,Germany,DEU,39,65,67,400,38,0,609,41,78,101,282,47,7,556,1165
2022,Egypt,EGY,Germany,DEU,112,188,120,490,33,23,966,99,189,152,1411,55,130,2036,3007
2022,Argentina,ARG,Germany,DEU,0,0,5,6,0,0,11,6,0,5,12,0,0,23,34
2022,Armenia,ARM,Germany,DEU,133,240,166,1836,504,168,3047,143,274,259,1991,358,201,3226,6282
2022,Australia,AUS,Germany,DEU,0,0,0,5,0,0,5,0,0,0,6,0,0,6,11
2022,Austria,AUT,Germany,DEU,0,0,5,0,0,0,5,0,0,0,0,0,0,0,5
2022,Azerbaijan,AZE,Germany,DEU,172,351,260,2069,379,213,3444,167,409,332,2589,275,375,4147,7596
2022,Bahrain,BHR,Germany,DEU,5,0,6,6,0,0,17,0,0,7,21,0,0,28,45
2022,Burundi,BDI,Germany,DEU,20,19,11,154,5,0,209,14,17,8,395,5,0,439,648
2022,Belgium,BEL,Germany,DEU,0,0,0,7,0,0,7,0,0,0,0,0,0,0,7
2022,Benin,BEN,Germany,DEU,19,5,5,61,0,5,95,15,12,16,108,5,0,156,251
2022,Bangladesh,BGD,Germany,DEU,31,21,15,89,5,0,161,13,22,27,541,17,9,629,790
2022,Bhutan,BTN,Germany,DEU,0,0,0,0,0,0,0,0,0,0,14,5,0,19,19
2022,Burkina Faso,BFA,Germany,DEU,16,11,5,73,0,0,105,11,8,5,117,0,5,146,251
2022,Belarus,BLR,Germany,DEU,31,89,44,458,72,69,763,33,88,48,459,52,59,739,1507
2022,Bolivia (Plurinational State of),BOL,Germany,DEU,0,0,0,5,0,0,5,0,9,0,0,8,0,17,22
2022,Botswana,BWA,Germany,DEU,0,5,0,0,0,0,5,0,0,0,0,0,0,0,5
2022,Brazil,BRA,Germany,DEU,6,10,5,16,5,0,42,12,0,0,27,0,0,39,81
2022,Bosnia and Herzegovina,BIH,Germany,DEU,72,143,82,674,223,0,1194,81,114,88,568,164,0,1015,2209
2022,Bulgaria,BGR,Germany,DEU,5,8,5,14,10,0,42,0,0,5,17,32,0,54,96
2022,Cambodia,KHM,Germany,DEU,0,5,5,19,0,0,29,0,0,0,30,8,0,38,67
2022,Canada,CAN,Germany,DEU,5,0,6,7,0,0,18,0,6,7,8,0,5,26,44
2022,Central African Rep.,CAF,Germany,DEU,0,0,0,6,0,0,6,5,0,0,27,0,0,32,38
2022,Chad,TCD,Germany,DEU,5,15,13,39,0,0,72,17,22,15,144,0,0,198,270
2022,China,CHN,Germany,DEU,38,47,34,622,84,16,841,28,43,54,830,153,35,1143,1984
2022,Chile,CHL,Germany,DEU,7,0,0,27,40,0,74,9,0,0,31,61,0,101,175
2022,Cameroon,CMR,Germany,DEU,95,68,29,682,54,37,965,92,63,48,1182,16,119,1520,2485
2022,Congo,COG,Germany,DEU,5,13,16,118,9,8,169,0,8,11,104,13,11,147,316
2022,Dem. Rep. of the Congo,COD,Germany,DEU,76,88,70,681,113,11,1039,88,76,64,633,144,23,1028,2067
2022,Comoros,COM,Germany,DEU,0,0,0,5,0,0,5,0,0,0,0,0,0,0,5
2022,Colombia,COL,Germany,DEU,53,95,93,633,26,0,900,62,89,76,753,18,0,998,1898
2022,Costa Rica,CRI,Germany,DEU,0,0,0,0,0,0,0,0,5,0,0,0,0,5,5
2022,Cuba,CUB,Germany,DEU,5,5,6,62,9,0,87,5,7,6,133,20,0,171,258
2022,Czechia,CZE,Germany,DEU,0,5,0,24,127,0,156,0,0,0,45,196,0,241,397
2022,Djibouti,DJI,Germany,DEU,6,0,0,27,0,0,33,6,0,0,26,0,0,32,65
2022,Dominica,DMA,Germany,DEU,0,0,0,5,0,0,5,0,0,0,0,0,0,0,5
2022,Dominican Rep.,DOM,Germany,DEU,0,0,0,5,0,0,5,0,0,0,11,0,0,11,16
2022,Ecuador,ECU,Germany,DEU,0,0,0,14,0,6,20,0,8,0,7,0,5,20,40
2022,Equatorial Guinea,GNQ,Germany,DEU,0,0,0,9,0,0,9,0,0,0,11,7,0,18,27
2022,Eritrea,ERI,Germany,DEU,3024,2144,853,10561,442,0,17024,3024,2297,952,24107,256,0,30636,47684
2022,Estonia,EST,Germany,DEU,0,0,0,5,0,0,5,0,0,0,0,0,0,0,5
2022,Ethiopia,ETH,Germany,DEU,670,521,106,2403,157,0,3857,667,590,110,2519,179,8,4073,7935
2022,France,FRA,Germany,DEU,0,0,0,0,0,0,0,0,0,0,6,6,0,12,12
2022,Gabon,GAB,Germany,DEU,5,5,0,10,0,0,20,0,0,0,15,0,0,15,35
2022,Gambia,GMB,Germany,DEU,121,64,29,390,0,0,604,117,51,48,1288,6,8,1518,2122
2022,Palestinian,PSE,Germany,DEU,72,118,125,481,34,0,830,64,151,126,1783,34,8,2166,2996
2022,United Kingdom of Great Britain and Northern Ireland,GBR,Germany,DEU,0,0,5,5,0,0,10,0,7,0,12,5,5,29,39
2022,Georgia,GEO,Germany,DEU,507,695,391,2729,225,120,4667,547,818,458,4004,174,238,6239,10906
2022,Ghana,GHA,Germany,DEU,101,76,26,324,35,58,620,78,72,27,596,61,124,958,1578
2022,Guinea-Bissau,GNB,Germany,DEU,15,0,5,33,0,0,53,11,6,8,96,0,0,121,174
2022,Greece,GRC,Germany,DEU,5,0,0,0,7,0,12,5,0,0,6,32,0,43,55
2022,Guatemala,GTM,Germany,DEU,0,0,5,6,0,0,11,0,0,0,6,0,0,6,17
2022,Guinea,GIN,Germany,DEU,584,156,85,1408,16,5,2254,548,156,104,2619,16,21,3464,5723
2022,Haiti,HTI,Germany,DEU,5,0,0,12,0,0,17,9,0,0,26,0,0,35,52
2022,"China, Hong Kong SAR",HKG,Germany,DEU,0,0,0,8,0,0,8,0,8,0,0,0,0,8,16
2022,Honduras,HND,Germany,DEU,8,5,5,44,0,0,62,0,15,7,52,0,0,74,136
2022,Croatia,HRV,Germany,DEU,0,0,10,75,32,0,117,0,0,0,55,91,0,146,263
2022,Hungary,HUN,Germany,DEU,0,0,5,14,66,0,85,0,0,0,19,128,0,147,232
2022,Cote d'Ivoire,CIV,Germany,DEU,161,76,30,422,5,5,699,138,71,31,548,5,15,808,1507
2022,India,IND,Germany,DEU,32,38,23,230,16,18,357,29,43,32,851,35,131,1121,1478
2022,Indonesia,IDN,Germany,DEU,0,5,0,5,0,0,10,0,0,0,10,0,0,10,20
2022,Iran (Islamic Rep. of),IRN,Germany,DEU,891,1221,957,10906,1491,83,15549,846,1283,1175,17610,2293,195,23402,38965
2022,Iraq,IRQ,Germany,DEU,4742,8889,7077,31992,2782,15,55497,4961,9605,8085,52677,2268,116,77712,133267
2022,Israel,ISR,Germany,DEU,0,11,5,27,10,0,53,5,5,6,51,8,16,91,144
2022,Italy,ITA,Germany,DEU,0,11,5,7,0,0,23,0,6,5,10,0,0,21,44
2022,Jamaica,JAM,Germany,DEU,0,0,0,18,0,0,18,0,0,0,43,0,0,43,61
2022,Jordan,JOR,Germany,DEU,47,34,36,257,18,6,398,35,45,48,527,21,64,740,1138
2022,Japan,JPN,Germany,DEU,0,0,10,9,0,0,19,0,0,8,15,0,0,23,42
2022,Kazakhstan,KAZ,Germany,DEU,6,26,16,160,45,22,275,15,24,15,149,18,11,232,507
2022,Kenya,KEN,Germany,DEU,27,13,11,315,8,5,379,19,21,11,199,5,0,255,634
2022,Kyrgyzstan,KGZ,Germany,DEU,20,42,25,169,14,9,279,20,34,34,160,8,5,261,540
2022,Rep. of Korea,KOR,Germany,DEU,0,0,0,21,0,5,26,0,5,0,11,0,0,16,42
2022,Dem. People's Rep. of Korea,PRK,Germany,DEU,0,0,0,36,10,0,46,0,0,0,39,11,0,50,96
2022,Kuwait,KWT,Germany,DEU,13,22,0,28,0,0,63,11,16,12,41,0,0,80,143
2022,Lao People's Dem. Rep.,LAO,Germany,DEU,0,0,0,0,6,0,6,0,0,0,21,16,0,37,43
2022,Liberia,LBR,Germany,DEU,23,14,0,100,0,5,142,26,0,5,217,5,10,263,405
2022,Libya,LBY,Germany,DEU,130,281,142,716,36,7,1312,153,316,200,1477,57,88,2291,3603
2022,Lebanon,LBN,Germany,DEU,167,300,240,1070,115,12,1904,224,352,243,1887,99,103,2908,4812
2022,Sri Lanka,LKA,Germany,DEU,42,61,61,607,258,0,1029,49,70,59,2029,388,0,2595,3624
2022,Lithuania,LTU,Germany,DEU,0,0,0,7,0,0,7,0,0,0,6,5,0,11,18
2022,Luxembourg,LUX,Germany,DEU,0,0,0,5,0,0,5,0,0,0,0,0,0,0,5
2022,Latvia,LVA,Germany,DEU,0,0,0,0,0,0,0,0,0,0,9,0,0,9,9
2022,Madagascar,MDG,Germany,DEU,0,0,0,6,0,0,6,0,0,0,10,0,0,10,16
2022,Mauritania,MRT,Germany,DEU,5,13,0,21,0,0,39,13,6,0,69,5,0,93,132
2022,North Macedonia,MKD,Germany,DEU,269,463,280,1206,70,0,2288,312,478,289,1177,104,5,2365,4653
2022,Rep. of Moldova,MDA,Germany,DEU,171,241,174,963,88,105,1742,173,232,167,1070,68,142,1852,3594
2022,Mexico,MEX,Germany,DEU,5,0,0,8,0,0,13,0,0,5,27,0,0,32,45
2022,Mali,MLI,Germany,DEU,28,17,10,75,0,0,130,24,22,17,381,0,0,444,574
2022,Malaysia,MYS,Germany,DEU,0,0,0,6,0,0,6,0,0,0,6,0,0,6,12
2022,Malawi,MWI,Germany,DEU,0,0,0,9,0,0,9,0,5,0,15,0,0,20,29
2022,Montenegro,MNE,Germany,DEU,24,31,21,137,22,0,235,22,25,27,145,12,0,231,466
2022,Mongolia,MNG,Germany,DEU,23,48,16,135,14,0,236,32,40,26,101,11,0,210,446
2022,Morocco,MAR,Germany,DEU,108,85,36,567,21,285,1102,123,109,60,1122,23,733,2170,3277
2022,Mozambique,MOZ,Germany,DEU,0,0,5,13,0,0,18,0,6,0,13,0,0,19,37
2022,Myanmar,MMR,Germany,DEU,15,25,25,289,30,0,384,26,29,25,635,56,0,771,1155
2022,Namibia,NAM,Germany,DEU,6,0,0,34,0,0,40,7,0,0,11,0,0,18,58
2022,Nepal,NPL,Germany,DEU,0,0,0,19,5,6,30,5,0,5,53,0,0,63,93
2022,Netherlands (Kingdom of the),NLD,Germany,DEU,6,6,0,7,0,0,19,10,10,0,5,0,0,25,44
2022,Niger,NER,Germany,DEU,5,5,0,25,0,0,35,9,0,6,90,0,5,110,145
2022,Nicaragua,NIC,Germany,DEU,11,21,12,128,0,0,172,16,37,10,156,0,0,219,391
2022,Nigeria,NGA,Germany,DEU,2305,1472,346,4329,28,242,8722,1922,1615,352,3831,35,690,8445,17176
2022,New Zealand,NZL,Germany,DEU,0,0,0,0,0,0,0,0,0,0,9,0,0,9,9
2022,Oman,OMN,Germany,DEU,0,5,0,7,0,0,12,0,5,0,0,0,0,5,17
2022,Pakistan,PAK,Germany,DEU,266,328,259,1790,370,7,3020,282,369,372,4809,335,115,6282,9307
2022,Panama,PAN,Germany,DEU,8,0,0,0,0,0,8,7,0,0,0,0,0,7,15
2022,Paraguay,PRY,Germany,DEU,5,0,0,0,0,0,5,0,0,0,10,0,0,10,15
2022,Peru,PER,Germany,DEU,7,0,5,40,9,0,61,0,7,0,40,6,0,53,114
2022,Philippines,PHL,Germany,DEU,0,10,5,34,8,0,57,7,6,0,16,0,0,29,86
2022,Palau,PLW,Germany,DEU,0,0,0,5,0,0,5,0,0,0,0,0,0,0,5
2022,Poland,POL,Germany,DEU,0,0,5,33,138,0,176,0,5,0,62,329,0,396,572
2022,Portugal,PRT,Germany,DEU,0,8,0,0,0,0,8,0,0,0,0,0,0,0,8
2022,Romania,ROU,Germany,DEU,0,0,9,25,25,0,59,0,5,5,49,61,0,120,179
2022,South Africa,ZAF,Germany,DEU,0,9,0,22,0,0,31,5,5,7,14,10,0,41,72
2022,Russian Federation,RUS,Germany,DEU,650,1663,1275,6217,1043,335,11183,684,1791,1425,5897,570,289,10656,21847
2022,Rwanda,RWA,Germany,DEU,26,23,13,345,6,0,413,39,34,11,456,10,7,557,970
2022,El Salvador,SLV,Germany,DEU,17,23,11,132,0,0,183,17,20,12,126,5,0,180,363
2022,Saudi Arabia,SAU,Germany,DEU,0,9,7,55,0,0,71,0,12,16,46,0,6,80,151
2022,Senegal,SEN,Germany,DEU,27,26,0,87,0,0,140,22,22,5,215,5,6,275,415
2022,Singapore,SGP,Germany,DEU,0,0,5,0,0,0,5,0,0,5,0,0,0,5,10
2022,Sierra Leone,SLE,Germany,DEU,72,41,19,258,6,7,403,71,49,32,557,9,11,729,1132
2022,Solomon Islands,SLB,Germany,DEU,0,0,0,0,0,0,0,0,0,0,5,0,0,5,5
2022,Somalia,SOM,Germany,DEU,2238,1359,925,7174,216,10,11922,2158,1975,1046,11764,173,5,17121,29060
2022,Spain,ESP,Germany,DEU,0,0,15,0,0,0,15,0,7,0,7,0,0,14,29
2022,Serbia and Kosovo: S/RES/1244 (1999),SRB,Germany,DEU,208,372,279,2636,847,0,4342,233,394,325,2434,726,5,4117,8459
2022,Viet Nam,VNM,Germany,DEU,33,17,20,1027,241,137,1475,9,15,33,1110,361,138,1666,3141
2022,South Sudan,SSD,Germany,DEU,0,6,5,22,0,0,33,0,13,8,114,0,0,135,168
2022,Stateless,XXA,Germany,DEU,256,496,534,2293,200,5,3784,234,571,632,4105,338,23,5903,9692
2022,Sudan,SDN,Germany,DEU,115,112,60,344,19,6,656,122,122,80,1909,37,44,2314,2970
2022,Slovakia,SVK,Germany,DEU,0,0,0,5,15,0,20,0,0,0,13,35,0,48,68
2022,Slovenia,SVN,Germany,DEU,0,0,0,0,0,0,0,0,0,0,0,7,0,7,7
2022,Eswatini,SWZ,Germany,DEU,0,0,0,5,0,0,5,0,0,5,0,0,0,5,10
2022,Sweden,SWE,Germany,DEU,0,0,0,8,0,0,8,5,5,0,0,0,0,10,18
2022,Syrian Arab Rep.,SYR,Germany,DEU,23736,37457,27016,122055,8419,25,218708,24826,40624,34324,247829,9942,115,357660,576793
2022,United Rep. of Tanzania,TZA,Germany,DEU,29,24,7,99,0,5,164,17,9,15,141,0,5,187,351
2022,Thailand,THA,Germany,DEU,0,0,5,27,0,0,32,0,0,5,17,5,0,27,59
2022,Tajikistan,TJK,Germany,DEU,116,160,98,559,12,55,1000,126,188,109,1139,14,98,1674,2680
2022,Turkmenistan,TKM,Germany,DEU,5,22,8,130,6,149,320,10,14,16,363,6,483,892,1212
2022,Timor-Leste,TLS,Germany,DEU,0,0,0,0,0,0,0,0,0,0,14,0,0,14,14
2022,Togo,TGO,Germany,DEU,42,14,12,306,27,0,401,35,12,20,693,105,0,865,1266
2022,Trinidad and Tobago,TTO,Germany,DEU,0,0,0,5,0,0,5,0,0,0,0,0,0,0,5
2022,Tunisia,TUN,Germany,DEU,45,50,22,295,9,24,445,63,53,35,1076,17,71,1315,1760
2022,Türkiye,TUR,Germany,DEU,1712,2312,1283,10967,1916,32,18222,1799,2687,1704,29960,2238,373,38761,57006
2022,United Arab Emirates,ARE,Germany,DEU,0,6,0,10,0,0,16,0,0,0,9,0,0,9,25
2022,Uganda,UGA,Germany,DEU,38,24,11,230,14,7,324,30,30,11,182,10,0,263,587
2022,Unknown ,UNK,Germany,DEU,2021,1895,1576,6684,776,69,13021,2068,2033,1867,13163,1004,128,20263,33335
2022,Ukraine,UKR,Germany,DEU,20851,49585,42073,276024,58032,191209,637774,21947,51855,43138,99819,23840,122877,363476,1004382
2022,Uruguay,URY,Germany,DEU,0,0,0,9,0,0,9,0,0,0,0,0,0,0,9
2022,United States of America,USA,Germany,DEU,0,24,15,40,14,5,98,7,37,19,64,21,13,161,259
2022,Uzbekistan,UZB,Germany,DEU,22,20,17,216,41,62,378,13,35,30,341,18,107,544,922
2022,Saint Vincent and the Grenadines,VCT,Germany,DEU,0,5,0,0,0,0,5,0,0,0,0,0,0,0,5
2022,Venezuela (Bolivarian Republic of),VEN,Germany,DEU,77,151,111,1030,146,0,1515,74,170,116,1229,69,0,1658,3173
2022,Yemen,YEM,Germany,DEU,128,206,180,872,44,0,1430,106,223,201,2893,56,14,3493,4929
2022,Zambia,ZMB,Germany,DEU,0,0,0,5,0,0,5,0,0,0,8,0,7,15,20
2022,Zimbabwe,ZWE,Germany,DEU,14,16,13,137,5,8,193,11,17,8,108,0,11,155,348
2022,Afghanistan,AFG,Ghana,GHA,0,0,0,10,0,0,10,0,0,0,5,0,0,5,15
2022,Egypt,EGY,Ghana,GHA,0,0,0,0,0,0,0,0,0,0,16,0,0,16,16
2022,Burundi,BDI,Ghana,GHA,0,9,0,5,0,0,14,0,0,0,15,0,0,15,29
2022,Benin,BEN,Ghana,GHA,0,0,0,0,0,0,0,0,0,0,13,0,0,13,13
2022,Burkina Faso,BFA,Ghana,GHA,123,135,79,309,48,0,694,119,138,43,93,26,0,419,1113
2022,Central African Rep.,CAF,Ghana,GHA,0,8,13,80,0,0,101,0,23,14,124,0,0,161,262
2022,Chad,TCD,Ghana,GHA,0,0,15,7,0,0,22,5,0,5,31,0,0,41,63
2022,Cameroon,CMR,Ghana,GHA,16,16,16,200,5,0,253,12,20,19,366,5,0,422,675
2022,Congo,COG,Ghana,GHA,0,0,8,5,0,0,13,0,0,0,0,0,0,0,13
2022,Dem. Rep. of the Congo,COD,Ghana,GHA,0,0,15,28,0,0,43,0,5,9,24,5,0,43,86
2022,Eritrea,ERI,Ghana,GHA,0,10,7,41,0,0,58,0,12,11,105,0,0,128,186
2022,Ethiopia,ETH,Ghana,GHA,0,0,0,7,0,0,7,5,0,0,5,0,0,10,17
2022,Palestinian,PSE,Ghana,GHA,0,9,0,5,0,0,14,0,5,0,9,0,0,14,28
2022,Cote d'Ivoire,CIV,Ghana,GHA,38,160,163,946,65,0,1372,15,167,207,1037,53,0,1479,2851
2022,Iraq,IRQ,Ghana,GHA,0,0,5,0,0,0,5,0,0,0,11,0,0,11,16
2022,Liberia,LBR,Ghana,GHA,5,25,30,266,28,0,354,13,24,30,200,8,0,275,629
2022,Libya,LBY,Ghana,GHA,0,0,7,0,0,0,7,0,0,0,6,0,0,6,13
2022,Lebanon,LBN,Ghana,GHA,0,0,0,0,0,0,0,0,5,0,5,0,0,10,10
2022,Mali,MLI,Ghana,GHA,0,0,5,0,0,0,5,0,0,0,0,0,0,0,5
2022,Niger,NER,Ghana,GHA,0,0,5,0,0,0,5,0,0,0,0,0,0,0,5
2022,Nigeria,NGA,Ghana,GHA,0,0,8,7,0,0,15,0,0,5,5,0,0,10,25
2022,Pakistan,PAK,Ghana,GHA,0,11,0,25,0,0,36,0,0,6,31,0,0,37,73
2022,Rwanda,RWA,Ghana,GHA,0,0,5,15,0,0,20,0,0,5,6,0,0,11,31
2022,Sierra Leone,SLE,Ghana,GHA,0,8,6,43,0,0,57,0,7,6,35,0,0,48,105
2022,Somalia,SOM,Ghana,GHA,0,7,13,29,0,0,49,0,8,9,52,0,0,69,118
2022,South Sudan,SSD,Ghana,GHA,0,0,0,0,0,0,0,0,0,0,12,0,0,12,12
2022,Sudan,SDN,Ghana,GHA,21,45,18,86,0,0,170,34,48,33,440,0,0,555,725
2022,Syrian Arab Rep.,SYR,Ghana,GHA,8,43,13,56,0,0,120,6,31,16,143,5,0,201,321
2022,Togo,TGO,Ghana,GHA,18,209,231,1018,121,0,1597,24,193,232,1273,158,0,1880,3477
2022,Türkiye,TUR,Ghana,GHA,5,8,0,21,0,0,34,0,5,6,24,0,0,35,69
2022,Uganda,UGA,Ghana,GHA,0,0,0,0,0,0,0,0,5,0,5,0,0,10,10
2022,Ukraine,UKR,Ghana,GHA,0,5,0,0,0,0,5,0,0,0,0,0,0,0,5
2022,Uzbekistan,UZB,Ghana,GHA,0,0,0,0,0,0,0,0,0,0,9,0,0,9,9
2022,Yemen,YEM,Ghana,GHA,0,0,0,5,0,0,5,0,0,7,11,0,0,18,23
2022,Cote d'Ivoire,CIV,Guinea-Bissau,GNB,0,0,0,0,0,0,0,0,0,0,12,0,0,12,12
2022,Liberia,LBR,Guinea-Bissau,GNB,0,0,0,0,0,0,0,0,0,0,8,0,0,8,8
2022,Nigeria,NGA,Guinea-Bissau,GNB,0,0,0,6,0,0,6,0,0,0,0,0,0,0,6
2022,Senegal,SEN,Guinea-Bissau,GNB,0,0,0,8,0,0,8,0,0,0,0,0,0,0,8
2022,Sierra Leone,SLE,Guinea-Bissau,GNB,0,0,5,0,0,0,5,0,0,0,10,0,0,10,15
2022,Türkiye,TUR,Guinea-Bissau,GNB,0,0,0,5,0,0,5,0,0,0,0,0,0,0,5
2022,Afghanistan,AFG,Greece,GRC,0,0,0,0,0,720,720,0,0,0,0,0,2059,2059,38246
2022,Albania,ALB,Greece,GRC,0,0,0,0,0,271,271,0,0,0,0,0,375,375,836
2022,Algeria,DZA,Greece,GRC,0,0,0,0,0,5,5,0,0,0,0,0,44,44,199
2022,Angola,AGO,Greece,GRC,0,0,0,0,0,20,20,0,0,0,0,0,23,23,64
2022,Egypt,EGY,Greece,GRC,0,0,0,0,0,169,169,0,0,0,0,0,1480,1480,2108
2022,Armenia,ARM,Greece,GRC,0,0,0,0,0,15,15,0,0,0,0,0,20,20,48
2022,Burundi,BDI,Greece,GRC,0,0,0,0,0,0,0,0,0,0,0,0,8,8,92
2022,Benin,BEN,Greece,GRC,0,0,0,0,0,0,0,0,0,0,0,0,0,0,5
2022,Bangladesh,BGD,Greece,GRC,0,0,0,0,0,20,20,0,0,0,0,0,1747,1747,2158
2022,Burkina Faso,BFA,Greece,GRC,0,0,0,0,0,0,0,0,0,0,0,0,20,20,75
2022,Belarus,BLR,Greece,GRC,0,0,0,0,0,0,0,0,0,0,0,0,0,0,8
2022,Brazil,BRA,Greece,GRC,0,0,0,0,0,0,0,0,0,0,0,0,0,0,5
2022,Central African Rep.,CAF,Greece,GRC,0,0,0,0,0,0,0,0,0,0,0,0,0,0,27
2022,Chad,TCD,Greece,GRC,0,0,0,0,0,0,0,0,0,0,0,0,5,5,19
2022,China,CHN,Greece,GRC,0,0,0,0,0,36,36,0,0,0,0,0,48,48,198
2022,Cameroon,CMR,Greece,GRC,0,0,0,0,0,151,151,0,0,0,0,0,193,193,1489
2022,Congo,COG,Greece,GRC,0,0,0,0,0,16,16,0,0,0,0,0,29,29,222
2022,Dem. Rep. of the Congo,COD,Greece,GRC,0,0,0,0,0,517,517,0,0,0,0,0,577,577,3827
2022,Comoros,COM,Greece,GRC,0,0,0,0,0,21,21,0,0,0,0,0,26,26,55
2022,Cuba,CUB,Greece,GRC,0,0,0,0,0,31,31,0,0,0,0,0,30,30,86
2022,Djibouti,DJI,Greece,GRC,0,0,0,0,0,5,5,0,0,0,0,0,9,9,42
2022,Dominican Rep.,DOM,Greece,GRC,0,0,0,0,0,0,0,0,0,0,0,0,0,0,10
2022,Equatorial Guinea,GNQ,Greece,GRC,0,0,0,0,0,0,0,0,0,0,0,0,0,0,5
2022,Eritrea,ERI,Greece,GRC,0,0,0,0,0,171,171,0,0,0,0,0,161,161,2124
2022,Ethiopia,ETH,Greece,GRC,0,0,0,0,0,40,40,0,0,0,0,0,59,59,739
2022,Gabon,GAB,Greece,GRC,0,0,0,0,0,5,5,0,0,0,0,0,5,5,15
2022,Gambia,GMB,Greece,GRC,0,0,0,0,0,5,5,0,0,0,0,0,75,75,216
2022,Palestinian,PSE,Greece,GRC,0,0,0,0,0,130,130,0,0,0,0,0,984,984,8628
2022,Georgia,GEO,Greece,GRC,0,0,0,0,0,202,202,0,0,0,0,0,210,210,670
2022,Ghana,GHA,Greece,GRC,0,0,0,0,0,35,35,0,0,0,0,0,107,107,244
2022,Guinea-Bissau,GNB,Greece,GRC,0,0,0,0,0,0,0,0,0,0,0,0,5,5,5
2022,Guinea,GIN,Greece,GRC,0,0,0,0,0,20,20,0,0,0,0,0,91,91,361
2022,Haiti,HTI,Greece,GRC,0,0,0,0,0,5,5,0,0,0,0,0,14,14,79
2022,Cote d'Ivoire,CIV,Greece,GRC,0,0,0,0,0,11,11,0,0,0,0,0,14,14,141
2022,India,IND,Greece,GRC,0,0,0,0,0,59,59,0,0,0,0,0,380,380,495
2022,Indonesia,IDN,Greece,GRC,0,0,0,0,0,0,0,0,0,0,0,0,0,0,26
2022,Iran (Islamic Rep. of),IRN,Greece,GRC,0,0,0,0,0,124,124,0,0,0,0,0,326,326,4031
2022,Iraq,IRQ,Greece,GRC,0,0,0,0,0,282,282,0,0,0,0,0,623,623,16609
2022,Jordan,JOR,Greece,GRC,0,0,0,0,0,5,5,0,0,0,0,0,0,0,50
2022,Kazakhstan,KAZ,Greece,GRC,0,0,0,0,0,0,0,0,0,0,0,0,0,0,5
2022,Kenya,KEN,Greece,GRC,0,0,0,0,0,6,6,0,0,0,0,0,0,0,37
2022,Kyrgyzstan,KGZ,Greece,GRC,0,0,0,0,0,5,5,0,0,0,0,0,0,0,5
2022,Kuwait,KWT,Greece,GRC,0,0,0,0,0,5,5,0,0,0,0,0,9,9,182
2022,Liberia,LBR,Greece,GRC,0,0,0,0,0,0,0,0,0,0,0,0,12,12,18
2022,Libya,LBY,Greece,GRC,0,0,0,0,0,0,0,0,0,0,0,0,5,5,76
2022,Lebanon,LBN,Greece,GRC,0,0,0,0,0,21,21,0,0,0,0,0,36,36,161
2022,Sri Lanka,LKA,Greece,GRC,0,0,0,0,0,5,5,0,0,0,0,0,15,15,75
2022,Mauritania,MRT,Greece,GRC,0,0,0,0,0,0,0,0,0,0,0,0,0,0,66
2022,North Macedonia,MKD,Greece,GRC,0,0,0,0,0,0,0,0,0,0,0,0,0,0,131
2022,Rep. of Moldova,MDA,Greece,GRC,0,0,0,0,0,32,32,0,0,0,0,0,5,5,51
2022,Mali,MLI,Greece,GRC,0,0,0,0,0,0,0,0,0,0,0,0,42,42,254
2022,Morocco,MAR,Greece,GRC,0,0,0,0,0,10,10,0,0,0,0,0,108,108,359
2022,Myanmar,MMR,Greece,GRC,0,0,0,0,0,0,0,0,0,0,0,0,5,5,113
2022,Nepal,NPL,Greece,GRC,0,0,0,0,0,29,29,0,0,0,0,0,34,34,93
2022,Niger,NER,Greece,GRC,0,0,0,0,0,0,0,0,0,0,0,0,6,6,25
2022,Nigeria,NGA,Greece,GRC,0,0,0,0,0,26,26,0,0,0,0,0,76,76,489
2022,Pakistan,PAK,Greece,GRC,0,0,0,0,0,39,39,0,0,0,0,0,2485,2485,3930
2022,Philippines,PHL,Greece,GRC,0,0,0,0,0,0,0,0,0,0,0,0,0,0,11
2022,Russian Federation,RUS,Greece,GRC,0,0,0,0,0,23,23,0,0,0,0,0,26,26,73
2022,Rwanda,RWA,Greece,GRC,0,0,0,0,0,0,0,0,0,0,0,0,0,0,9
2022,El Salvador,SLV,Greece,GRC,0,0,0,0,0,0,0,0,0,0,0,0,0,0,12
2022,Saudi Arabia,SAU,Greece,GRC,0,0,0,0,0,0,0,0,0,0,0,0,0,0,8
2022,Senegal,SEN,Greece,GRC,0,0,0,0,0,6,6,0,0,0,0,0,49,49,126
2022,Sierra Leone,SLE,Greece,GRC,0,0,0,0,0,159,159,0,0,0,0,0,316,316,890
2022,Somalia,SOM,Greece,GRC,0,0,0,0,0,522,522,0,0,0,0,0,640,640,6421
2022,Serbia and Kosovo: S/RES/1244 (1999),SRB,Greece,GRC,0,0,0,0,0,0,0,0,0,0,0,0,0,0,23
2022,Viet Nam,VNM,Greece,GRC,0,0,0,0,0,0,0,0,0,0,0,0,0,0,5
2022,South Sudan,SSD,Greece,GRC,0,0,0,0,0,5,5,0,0,0,0,0,9,9,75
2022,Stateless,XXA,Greece,GRC,0,0,0,0,0,5,5,0,0,0,0,0,17,17,845
2022,Sudan,SDN,Greece,GRC,0,0,0,0,0,15,15,0,0,0,0,0,221,221,1023
2022,Syrian Arab Rep.,SYR,Greece,GRC,0,0,0,0,0,457,457,0,0,0,0,0,2063,2063,45347
2022,United Rep. of Tanzania,TZA,Greece,GRC,0,0,0,0,0,0,0,0,0,0,0,0,7,7,20
2022,Tajikistan,TJK,Greece,GRC,0,0,0,0,0,0,0,0,0,0,0,0,0,0,5
2022,Turkmenistan,TKM,Greece,GRC,0,0,0,0,0,0,0,0,0,0,0,0,5,5,12
2022,Togo,TGO,Greece,GRC,0,0,0,0,0,5,5,0,0,0,0,0,35,35,148
2022,Tunisia,TUN,Greece,GRC,0,0,0,0,0,0,0,0,0,0,0,0,5,5,37
2022,Türkiye,TUR,Greece,GRC,0,0,0,0,0,290,290,0,0,0,0,0,940,940,2822
2022,Uganda,UGA,Greece,GRC,0,0,0,0,0,25,25,0,0,0,0,0,19,19,140
2022,Unknown ,UNK,Greece,GRC,0,0,0,0,0,0,0,0,0,0,0,0,0,0,11049
2022,Ukraine,UKR,Greece,GRC,0,0,0,0,0,14912,14912,0,0,0,0,0,6724,6724,21931
2022,Uzbekistan,UZB,Greece,GRC,0,0,0,0,0,0,0,0,0,0,0,0,0,0,12
2022,Venezuela (Bolivarian Republic of),VEN,Greece,GRC,0,0,0,0,0,0,0,0,0,0,0,0,0,0,15
2022,Western Sahara,ESH,Greece,GRC,0,0,0,0,0,0,0,0,0,0,0,0,0,0,10
2022,Yemen,YEM,Greece,GRC,0,0,0,0,0,40,40,0,0,0,0,0,109,109,1484
2022,Zimbabwe,ZWE,Greece,GRC,0,0,0,0,0,5,5,0,0,0,0,0,0,0,20
2022,Brazil,BRA,Guatemala,GTM,0,6,0,0,0,0,6,0,0,0,0,0,0,0,6
2022,Congo,COG,Guatemala,GTM,0,0,0,0,0,0,0,0,0,0,5,0,0,5,5
2022,Colombia,COL,Guatemala,GTM,0,0,0,9,0,0,9,0,0,5,23,0,0,28,37
2022,Cuba,CUB,Guatemala,GTM,0,0,0,5,0,0,5,0,5,0,14,5,0,24,29
2022,Ecuador,ECU,Guatemala,GTM,0,0,0,0,0,0,0,0,0,0,5,0,0,5,5
2022,Haiti,HTI,Guatemala,GTM,0,0,0,0,0,0,0,0,0,0,5,0,0,5,5
2022,Honduras,HND,Guatemala,GTM,23,59,63,209,5,0,359,23,60,30,194,18,0,325,684
2022,Mexico,MEX,Guatemala,GTM,0,0,0,5,0,0,5,0,6,0,0,0,0,6,11
2022,Nicaragua,NIC,Guatemala,GTM,0,14,14,122,5,0,155,0,12,10,163,12,0,197,352
2022,Pakistan,PAK,Guatemala,GTM,0,0,0,0,0,0,0,0,0,0,5,0,0,5,5
2022,Russian Federation,RUS,Guatemala,GTM,0,0,0,5,0,0,5,0,0,0,0,0,0,0,5
2022,El Salvador,SLV,Guatemala,GTM,16,57,45,261,29,0,408,15,55,51,278,34,0,433,841
2022,Ukraine,UKR,Guatemala,GTM,0,0,5,0,0,0,5,0,0,0,0,0,0,0,5
2022,United States of America,USA,Guatemala,GTM,0,0,0,0,0,0,0,0,0,0,5,0,0,5,5
2022,Venezuela (Bolivarian Republic of),VEN,Guatemala,GTM,5,17,5,62,10,0,99,0,25,5,91,5,0,126,225
2022,Burundi,BDI,Guinea,GIN,0,0,0,5,0,0,5,0,0,0,0,0,0,0,5
2022,Central African Rep.,CAF,Guinea,GIN,0,5,5,10,0,0,20,0,0,6,10,0,0,16,36
2022,Congo,COG,Guinea,GIN,0,0,0,6,0,0,6,5,0,0,0,0,0,5,11
2022,Dem. Rep. of the Congo,COD,Guinea,GIN,0,0,7,16,0,0,23,0,6,11,14,0,0,31,54
2022,Eritrea,ERI,Guinea,GIN,0,0,0,6,0,0,6,0,0,0,8,0,0,8,14
2022,Gambia,GMB,Guinea,GIN,0,0,0,0,0,0,0,0,0,0,7,0,0,7,7
2022,Cote d'Ivoire,CIV,Guinea,GIN,0,0,5,12,0,0,17,0,0,0,5,0,0,5,22
2022,Liberia,LBR,Guinea,GIN,16,30,23,106,5,0,180,10,24,32,88,14,0,168,348
2022,Sri Lanka,LKA,Guinea,GIN,0,0,0,5,0,0,5,5,0,0,0,0,0,5,10
2022,Mali,MLI,Guinea,GIN,0,0,0,0,0,0,0,0,0,0,9,0,0,9,9
2022,Nigeria,NGA,Guinea,GIN,0,0,0,5,0,0,5,0,0,0,5,0,0,5,10
2022,Rwanda,RWA,Guinea,GIN,0,0,5,0,0,0,5,0,0,0,5,0,0,5,10
2022,Sierra Leone,SLE,Guinea,GIN,26,107,128,557,11,0,829,35,97,124,597,6,0,859,1688
2022,Somalia,SOM,Guinea,GIN,0,0,6,0,0,0,6,0,0,0,0,0,0,0,6
2022,Syrian Arab Rep.,SYR,Guinea,GIN,0,0,0,7,0,0,7,0,0,0,7,0,0,7,14
2022,Togo,TGO,Guinea,GIN,0,0,0,0,0,0,0,0,0,0,8,0,0,8,8
2022,Afghanistan,AFG,Guyana,GUY,0,0,0,0,0,0,0,0,5,0,0,0,0,5,5
2022,Cambodia,KHM,Guyana,GUY,0,0,0,0,0,0,0,0,0,0,5,0,0,5,5
2022,Cameroon,CMR,Guyana,GUY,0,0,0,0,0,0,0,0,0,0,0,0,0,0,5
2022,Cuba,CUB,Guyana,GUY,0,0,5,41,0,0,46,0,0,6,78,5,0,89,135
2022,Haiti,HTI,Guyana,GUY,0,0,5,8,0,0,13,0,0,0,5,0,0,5,18
2022,Venezuela (Bolivarian Republic of),VEN,Guyana,GUY,0,0,0,0,0,0,0,0,0,0,0,0,0,0,19642
2022,Afghanistan,AFG,"China, Hong Kong SAR",HKG,0,0,0,0,0,0,0,0,6,0,5,0,0,11,11
2022,Egypt,EGY,"China, Hong Kong SAR",HKG,0,6,0,0,0,0,6,0,0,0,7,0,0,7,13
2022,Burundi,BDI,"China, Hong Kong SAR",HKG,0,9,0,0,0,0,9,0,0,0,0,0,0,0,9
2022,Bangladesh,BGD,"China, Hong Kong SAR",HKG,0,0,0,5,0,0,5,0,0,0,11,0,0,11,16
2022,Central African Rep.,CAF,"China, Hong Kong SAR",HKG,0,0,0,0,0,0,0,0,0,0,5,0,0,5,5
2022,Cameroon,CMR,"China, Hong Kong SAR",HKG,0,0,0,0,0,0,0,0,0,0,5,0,0,5,5
2022,Dem. Rep. of the Congo,COD,"China, Hong Kong SAR",HKG,0,0,0,0,0,0,0,0,0,0,8,0,0,8,8
2022,Ethiopia,ETH,"China, Hong Kong SAR",HKG,0,0,6,0,0,0,6,0,0,0,0,0,0,0,6
2022,Palestinian,PSE,"China, Hong Kong SAR",HKG,0,0,0,0,0,0,0,0,0,0,5,0,0,5,5
2022,Indonesia,IDN,"China, Hong Kong SAR",HKG,0,0,0,8,0,0,8,0,0,0,5,0,0,5,13
2022,Sri Lanka,LKA,"China, Hong Kong SAR",HKG,0,0,0,6,0,0,6,0,0,0,15,0,0,15,21
2022,Nepal,NPL,"China, Hong Kong SAR",HKG,0,0,0,0,0,0,0,0,0,8,0,0,0,8,8
2022,Pakistan,PAK,"China, Hong Kong SAR",HKG,0,0,0,9,0,0,9,0,5,0,15,0,0,20,29
2022,Philippines,PHL,"China, Hong Kong SAR",HKG,0,0,0,8,0,0,8,0,0,0,0,0,0,0,8
2022,Rwanda,RWA,"China, Hong Kong SAR",HKG,0,0,8,9,0,0,17,5,6,0,9,0,0,20,37
2022,Somalia,SOM,"China, Hong Kong SAR",HKG,0,0,0,9,0,0,9,7,0,0,16,0,0,23,32
2022,Sudan,SDN,"China, Hong Kong SAR",HKG,0,0,0,0,0,0,0,5,0,0,0,0,0,5,5
2022,Uganda,UGA,"China, Hong Kong SAR",HKG,0,0,0,0,0,0,0,0,0,0,5,0,0,5,5
2022,Yemen,YEM,"China, Hong Kong SAR",HKG,0,8,0,15,0,0,23,0,0,7,14,0,0,21,44
2022,Zimbabwe,ZWE,"China, Hong Kong SAR",HKG,0,0,0,0,0,0,0,0,5,0,0,0,0,5,5
2022,Colombia,COL,Honduras,HND,0,0,0,0,0,0,0,0,0,0,5,0,0,5,5
2022,Cuba,CUB,Honduras,HND,0,0,0,9,0,0,9,0,0,0,0,0,0,0,9
2022,Nicaragua,NIC,Honduras,HND,0,12,7,47,0,0,66,0,7,9,88,11,0,115,181
2022,El Salvador,SLV,Honduras,HND,0,6,0,14,0,0,20,0,0,5,14,0,0,19,39
2022,Venezuela (Bolivarian Republic of),VEN,Honduras,HND,0,0,0,14,0,0,14,0,0,5,19,0,0,24,38
2022,Afghanistan,AFG,Croatia,HRV,0,0,0,0,0,162,162,0,0,0,0,0,243,243,405
2022,Algeria,DZA,Croatia,HRV,0,0,0,0,0,0,0,0,0,0,0,0,6,6,6
2022,Egypt,EGY,Croatia,HRV,0,0,0,0,0,0,0,0,0,0,0,0,8,8,8
2022,Armenia,ARM,Croatia,HRV,0,0,0,5,0,0,5,0,0,0,0,0,0,0,5
2022,Azerbaijan,AZE,Croatia,HRV,0,0,0,0,0,0,0,0,0,0,8,0,0,8,8
2022,Burundi,BDI,Croatia,HRV,0,0,0,0,0,68,68,0,0,0,0,0,89,89,157
2022,Bangladesh,BGD,Croatia,HRV,0,0,0,0,0,0,0,0,0,0,0,0,18,18,18
2022,Belarus,BLR,Croatia,HRV,0,0,0,10,0,0,10,0,0,0,5,0,0,5,15
2022,Bolivia (Plurinational State of),BOL,Croatia,HRV,0,0,0,0,0,7,7,0,0,0,0,0,0,0,7
2022,Canada,CAN,Croatia,HRV,0,0,0,0,0,0,0,0,0,0,5,0,0,5,5
2022,China,CHN,Croatia,HRV,0,0,0,0,0,0,0,0,0,0,0,0,6,6,6
2022,Cameroon,CMR,Croatia,HRV,0,0,0,0,0,5,5,0,0,0,0,0,13,13,18
2022,Congo,COG,Croatia,HRV,0,0,0,0,0,0,0,0,0,0,0,0,6,6,6
2022,Dem. Rep. of the Congo,COD,Croatia,HRV,0,0,0,0,0,8,8,0,0,0,0,0,17,17,25
2022,Cuba,CUB,Croatia,HRV,0,0,0,0,0,23,23,0,0,0,0,0,44,44,67
2022,Eritrea,ERI,Croatia,HRV,0,0,0,0,0,5,5,0,0,0,0,0,22,22,27
2022,Palestinian,PSE,Croatia,HRV,0,0,0,0,0,7,7,0,0,0,0,0,18,18,25
2022,United Kingdom of Great Britain and Northern Ireland,GBR,Croatia,HRV,0,0,0,5,0,0,5,0,0,0,0,0,0,0,5
2022,Georgia,GEO,Croatia,HRV,0,0,5,5,0,5,15,5,0,0,5,0,0,10,25
2022,Guinea,GIN,Croatia,HRV,0,0,0,0,0,6,6,0,0,0,0,0,0,0,6
2022,India,IND,Croatia,HRV,0,0,0,0,0,0,0,0,0,0,0,0,5,5,5
2022,Iran (Islamic Rep. of),IRN,Croatia,HRV,0,0,0,0,0,35,35,0,0,0,0,0,42,42,77
2022,Iraq,IRQ,Croatia,HRV,0,0,0,0,0,57,57,0,0,0,0,0,137,137,194
2022,Kazakhstan,KAZ,Croatia,HRV,0,0,0,0,0,0,0,0,6,0,0,0,5,11,11
2022,Libya,LBY,Croatia,HRV,0,0,0,0,0,5,5,0,0,0,0,0,0,0,5
2022,Mauritania,MRT,Croatia,HRV,0,0,0,0,0,0,0,0,0,0,0,0,5,5,5
2022,Rep. of Moldova,MDA,Croatia,HRV,0,0,0,0,0,8,8,0,0,0,0,0,0,0,8
2022,Mali,MLI,Croatia,HRV,0,0,0,0,0,0,0,0,0,0,0,0,5,5,5
2022,Montenegro,MNE,Croatia,HRV,0,0,0,0,0,5,5,0,0,0,0,0,0,0,5
2022,Mongolia,MNG,Croatia,HRV,0,0,0,0,0,0,0,0,0,0,0,0,6,6,6
2022,Morocco,MAR,Croatia,HRV,0,0,0,0,0,5,5,0,0,0,0,0,43,43,48
2022,Nepal,NPL,Croatia,HRV,0,0,0,0,0,9,9,0,0,0,0,0,11,11,20
2022,Nigeria,NGA,Croatia,HRV,0,0,0,0,0,5,5,0,0,0,0,0,10,10,15
2022,Pakistan,PAK,Croatia,HRV,0,0,0,0,0,6,6,0,0,0,0,0,34,34,40
2022,Russian Federation,RUS,Croatia,HRV,0,5,0,25,0,86,116,0,5,0,23,0,180,208,324
2022,Somalia,SOM,Croatia,HRV,0,0,0,0,0,20,20,0,0,0,0,0,22,22,42
2022,Serbia and Kosovo: S/RES/1244 (1999),SRB,Croatia,HRV,0,0,5,0,0,5,10,0,0,0,0,0,0,0,10
2022,Stateless,XXA,Croatia,HRV,0,0,0,0,0,0,0,0,0,0,0,0,11,11,11
2022,Sudan,SDN,Croatia,HRV,0,0,0,0,0,5,5,0,0,0,0,0,0,0,5
2022,Syrian Arab Rep.,SYR,Croatia,HRV,0,0,0,0,0,233,233,0,0,0,0,0,361,361,594
2022,Tunisia,TUN,Croatia,HRV,0,0,0,0,0,9,9,0,0,0,0,0,0,0,9
2022,Türkiye,TUR,Croatia,HRV,0,0,0,0,0,39,39,0,0,0,0,0,68,68,107
2022,Unknown ,UNK,Croatia,HRV,0,0,0,0,0,0,0,0,0,0,0,0,7,7,7
2022,Ukraine,UKR,Croatia,HRV,797,1430,949,8520,0,1355,13051,746,1468,1175,2390,0,586,6365,19416
2022,United States of America,USA,Croatia,HRV,0,0,0,0,0,0,0,0,0,0,8,0,0,8,8
2022,Uzbekistan,UZB,Croatia,HRV,0,0,0,0,0,0,0,0,0,0,0,0,5,5,5
2022,Western Sahara,ESH,Croatia,HRV,0,0,0,0,0,0,0,0,0,0,0,0,5,5,5
2022,Yemen,YEM,Croatia,HRV,0,0,0,0,0,0,0,0,0,0,0,0,7,7,7
2022,Afghanistan,AFG,Hungary,HUN,0,0,0,0,0,0,0,0,0,0,0,0,0,0,1457
2022,Algeria,DZA,Hungary,HUN,0,0,0,0,0,0,0,0,0,0,0,0,0,0,14
2022,Angola,AGO,Hungary,HUN,0,0,0,0,0,0,0,0,0,0,0,0,0,0,5
2022,Egypt,EGY,Hungary,HUN,0,0,0,0,0,0,0,0,0,0,0,0,0,0,17
2022,Armenia,ARM,Hungary,HUN,0,0,0,0,0,0,0,0,0,0,0,0,0,0,46
2022,Azerbaijan,AZE,Hungary,HUN,0,0,0,0,0,0,0,0,0,0,0,0,0,0,18
2022,Bangladesh,BGD,Hungary,HUN,0,0,0,0,0,0,0,0,0,0,0,0,0,0,11
2022,Belarus,BLR,Hungary,HUN,0,0,0,0,0,0,0,0,0,0,0,0,0,0,7
2022,Canada,CAN,Hungary,HUN,0,0,0,0,0,0,0,0,0,0,0,0,0,0,5
2022,China,CHN,Hungary,HUN,0,0,0,0,0,0,0,0,0,0,0,0,0,0,15
2022,Cameroon,CMR,Hungary,HUN,0,0,0,0,0,0,0,0,0,0,0,0,0,0,43
2022,Congo,COG,Hungary,HUN,0,0,0,0,0,0,0,0,0,0,0,0,0,0,12
2022,Dem. Rep. of the Congo,COD,Hungary,HUN,0,0,0,0,0,0,0,0,0,0,0,0,0,0,24
2022,Cuba,CUB,Hungary,HUN,0,0,0,0,0,0,0,0,0,0,0,0,0,0,74
2022,Ecuador,ECU,Hungary,HUN,0,0,0,0,0,0,0,0,0,0,0,0,0,0,5
2022,Eritrea,ERI,Hungary,HUN,0,0,0,0,0,0,0,0,0,0,0,0,0,0,47
2022,Ethiopia,ETH,Hungary,HUN,0,0,0,0,0,0,0,0,0,0,0,0,0,0,41
2022,Palestinian,PSE,Hungary,HUN,0,0,0,0,0,0,0,0,0,0,0,0,0,0,86
2022,United Kingdom of Great Britain and Northern Ireland,GBR,Hungary,HUN,0,0,0,0,0,0,0,0,0,0,0,0,0,0,5
2022,Georgia,GEO,Hungary,HUN,0,0,0,0,0,0,0,0,0,0,0,0,0,0,63
2022,Ghana,GHA,Hungary,HUN,0,0,0,0,0,0,0,0,0,0,0,0,0,0,12
2022,Guinea,GIN,Hungary,HUN,0,0,0,0,0,0,0,0,0,0,0,0,0,0,5
2022,Cote d'Ivoire,CIV,Hungary,HUN,0,0,0,0,0,0,0,0,0,0,0,0,0,0,15
2022,India,IND,Hungary,HUN,0,0,0,0,0,0,0,0,0,0,0,0,0,0,6
2022,Iran (Islamic Rep. of),IRN,Hungary,HUN,0,0,0,0,0,0,0,0,0,0,0,0,0,0,197
2022,Iraq,IRQ,Hungary,HUN,0,0,0,0,0,0,0,0,0,0,0,0,0,0,592
2022,Israel,ISR,Hungary,HUN,0,0,0,0,0,0,0,0,0,0,0,0,0,0,9
2022,Jordan,JOR,Hungary,HUN,0,0,0,0,0,0,0,0,0,0,0,0,0,0,5
2022,Libya,LBY,Hungary,HUN,0,0,0,0,0,0,0,0,0,0,0,0,0,0,7
2022,Lebanon,LBN,Hungary,HUN,0,0,0,0,0,0,0,0,0,0,0,0,0,0,5
2022,Sri Lanka,LKA,Hungary,HUN,0,0,0,0,0,0,0,0,0,0,0,0,0,0,11
2022,Rep. of Moldova,MDA,Hungary,HUN,0,0,0,0,0,0,0,0,0,0,0,0,0,0,11
2022,Morocco,MAR,Hungary,HUN,0,0,0,0,0,0,0,0,0,0,0,0,0,0,5
2022,Nepal,NPL,Hungary,HUN,0,0,0,0,0,0,0,0,0,0,0,0,0,0,9
2022,Nigeria,NGA,Hungary,HUN,0,0,0,0,0,0,0,0,0,0,0,0,0,0,78
2022,Pakistan,PAK,Hungary,HUN,0,0,0,0,0,0,0,0,0,0,0,0,0,0,91
2022,Romania,ROU,Hungary,HUN,0,0,0,0,0,0,0,0,0,0,0,0,0,0,27
2022,Russian Federation,RUS,Hungary,HUN,0,0,0,0,0,0,0,0,0,0,0,0,0,0,105
2022,Sierra Leone,SLE,Hungary,HUN,0,0,0,0,0,0,0,0,0,0,0,0,0,0,5
2022,Somalia,SOM,Hungary,HUN,0,0,0,0,0,0,0,0,0,0,0,0,0,0,595
2022,Serbia and Kosovo: S/RES/1244 (1999),SRB,Hungary,HUN,0,0,0,0,0,0,0,0,0,0,0,0,0,0,37
2022,Stateless,XXA,Hungary,HUN,0,0,0,0,0,0,0,0,0,0,0,0,0,0,61
2022,Sudan,SDN,Hungary,HUN,0,0,0,0,0,0,0,0,0,0,0,0,0,0,62
2022,Syrian Arab Rep.,SYR,Hungary,HUN,0,0,0,0,0,0,0,0,0,0,0,0,0,0,819
2022,Tunisia,TUN,Hungary,HUN,0,0,0,0,0,0,0,0,0,0,0,0,0,0,7
2022,Türkiye,TUR,Hungary,HUN,0,0,0,0,0,0,0,0,0,0,0,0,0,0,37
2022,Uganda,UGA,Hungary,HUN,0,0,0,0,0,0,0,0,0,0,0,0,0,0,8
2022,Unknown ,UNK,Hungary,HUN,0,0,0,0,0,0,0,0,0,0,0,0,0,0,896
2022,Ukraine,UKR,Hungary,HUN,0,0,0,0,0,19549,19549,0,0,0,0,0,10070,10070,29637
2022,United States of America,USA,Hungary,HUN,0,0,0,0,0,0,0,0,0,0,0,0,0,0,7
2022,Uzbekistan,UZB,Hungary,HUN,0,0,0,0,0,0,0,0,0,0,0,0,0,0,12
2022,Yemen,YEM,Hungary,HUN,0,0,0,0,0,0,0,0,0,0,0,0,0,0,17
2022,Zimbabwe,ZWE,Hungary,HUN,0,0,0,0,0,0,0,0,0,0,0,0,0,0,5
2022,Afghanistan,AFG,Iceland,ISL,0,0,0,0,0,0,0,0,0,0,0,0,0,0,236
2022,Albania,ALB,Iceland,ISL,0,0,0,0,0,0,0,0,0,0,0,0,0,0,5
2022,Egypt,EGY,Iceland,ISL,0,0,0,0,0,0,0,0,0,0,0,0,0,0,16
2022,Azerbaijan,AZE,Iceland,ISL,0,0,0,0,0,0,0,0,0,0,0,0,0,0,5
2022,Bangladesh,BGD,Iceland,ISL,0,0,0,0,0,0,0,0,0,0,0,0,0,0,5
2022,Belarus,BLR,Iceland,ISL,0,0,0,0,0,0,0,0,0,0,0,0,0,0,6
2022,Bolivia (Plurinational State of),BOL,Iceland,ISL,0,0,0,0,0,0,0,0,0,0,0,0,0,0,5
2022,Chad,TCD,Iceland,ISL,0,0,0,0,0,0,0,0,0,0,0,0,0,0,5
2022,China,CHN,Iceland,ISL,0,0,0,0,0,0,0,0,0,0,0,0,0,0,5
2022,Cameroon,CMR,Iceland,ISL,0,0,0,0,0,0,0,0,0,0,0,0,0,0,5
2022,Dem. Rep. of the Congo,COD,Iceland,ISL,0,0,0,0,0,0,0,0,0,0,0,0,0,0,5
2022,Colombia,COL,Iceland,ISL,0,0,0,0,0,0,0,0,0,0,0,0,0,0,30
2022,Eritrea,ERI,Iceland,ISL,0,0,0,0,0,0,0,0,0,0,0,0,0,0,9
2022,Ethiopia,ETH,Iceland,ISL,0,0,0,0,0,0,0,0,0,0,0,0,0,0,14
2022,Palestinian,PSE,Iceland,ISL,0,0,0,0,0,0,0,0,0,0,0,0,0,0,324
2022,Georgia,GEO,Iceland,ISL,0,0,0,0,0,0,0,0,0,0,0,0,0,0,6
2022,Ghana,GHA,Iceland,ISL,0,0,0,0,0,0,0,0,0,0,0,0,0,0,12
2022,Guatemala,GTM,Iceland,ISL,0,0,0,0,0,0,0,0,0,0,0,0,0,0,5
2022,Honduras,HND,Iceland,ISL,0,0,0,0,0,0,0,0,0,0,0,0,0,0,13
2022,Cote d'Ivoire,CIV,Iceland,ISL,0,0,0,0,0,0,0,0,0,0,0,0,0,0,5
2022,Iran (Islamic Rep. of),IRN,Iceland,ISL,0,0,0,0,0,0,0,0,0,0,0,0,0,0,123
2022,Iraq,IRQ,Iceland,ISL,0,0,0,0,0,0,0,0,0,0,0,0,0,0,371
2022,Jordan,JOR,Iceland,ISL,0,0,0,0,0,0,0,0,0,0,0,0,0,0,17
2022,Kazakhstan,KAZ,Iceland,ISL,0,0,0,0,0,0,0,0,0,0,0,0,0,0,5
2022,Kenya,KEN,Iceland,ISL,0,0,0,0,0,0,0,0,0,0,0,0,0,0,5
2022,Libya,LBY,Iceland,ISL,0,0,0,0,0,0,0,0,0,0,0,0,0,0,28
2022,Lebanon,LBN,Iceland,ISL,0,0,0,0,0,0,0,0,0,0,0,0,0,0,5
2022,Sri Lanka,LKA,Iceland,ISL,0,0,0,0,0,0,0,0,0,0,0,0,0,0,5
2022,North Macedonia,MKD,Iceland,ISL,0,0,0,0,0,0,0,0,0,0,0,0,0,0,5
2022,Rep. of Moldova,MDA,Iceland,ISL,0,0,0,0,0,0,0,0,0,0,0,0,0,0,12
2022,Mexico,MEX,Iceland,ISL,0,0,0,0,0,0,0,0,0,0,0,0,0,0,5
2022,Mali,MLI,Iceland,ISL,0,0,0,0,0,0,0,0,0,0,0,0,0,0,5
2022,Mongolia,MNG,Iceland,ISL,0,0,0,0,0,0,0,0,0,0,0,0,0,0,5
2022,Morocco,MAR,Iceland,ISL,0,0,0,0,0,0,0,0,0,0,0,0,0,0,9
2022,Mozambique,MOZ,Iceland,ISL,0,0,0,0,0,0,0,0,0,0,0,0,0,0,5
2022,Nigeria,NGA,Iceland,ISL,0,0,0,0,0,0,0,0,0,0,0,0,0,0,99
2022,Pakistan,PAK,Iceland,ISL,0,0,0,0,0,0,0,0,0,0,0,0,0,0,27
2022,Panama,PAN,Iceland,ISL,0,0,0,0,0,0,0,0,0,0,0,0,0,0,5
2022,Peru,PER,Iceland,ISL,0,0,0,0,0,0,0,0,0,0,0,0,0,0,5
2022,Russian Federation,RUS,Iceland,ISL,0,0,0,0,0,0,0,0,0,0,0,0,0,0,50
2022,El Salvador,SLV,Iceland,ISL,0,0,0,0,0,0,0,0,0,0,0,0,0,0,30
2022,Senegal,SEN,Iceland,ISL,0,0,0,0,0,0,0,0,0,0,0,0,0,0,10
2022,Somalia,SOM,Iceland,ISL,0,0,0,0,0,0,0,0,0,0,0,0,0,0,185
2022,South Sudan,SSD,Iceland,ISL,0,0,0,0,0,0,0,0,0,0,0,0,0,0,5
2022,Stateless,XXA,Iceland,ISL,0,0,0,0,0,0,0,0,0,0,0,0,0,0,22
2022,Sudan,SDN,Iceland,ISL,0,0,0,0,0,0,0,0,0,0,0,0,0,0,10
2022,Syrian Arab Rep.,SYR,Iceland,ISL,0,0,0,0,0,0,0,0,0,0,0,0,0,0,265
2022,Tajikistan,TJK,Iceland,ISL,0,0,0,0,0,0,0,0,0,0,0,0,0,0,5
2022,Tunisia,TUN,Iceland,ISL,0,0,0,0,0,0,0,0,0,0,0,0,0,0,5
2022,Türkiye,TUR,Iceland,ISL,0,0,0,0,0,0,0,0,0,0,0,0,0,0,27
2022,Uganda,UGA,Iceland,ISL,0,0,0,0,0,0,0,0,0,0,0,0,0,0,19
2022,Unknown ,UNK,Iceland,ISL,0,0,0,0,0,0,0,0,0,0,0,0,0,0,12
2022,Ukraine,UKR,Iceland,ISL,0,0,0,0,0,1357,1357,0,0,0,0,0,943,943,2335
2022,Venezuela (Bolivarian Republic of),VEN,Iceland,ISL,0,0,0,0,0,0,0,0,0,0,0,0,0,0,1768
2022,Yemen,YEM,Iceland,ISL,0,0,0,0,0,0,0,0,0,0,0,0,0,0,16
2022,Egypt,EGY,Cote d'Ivoire,CIV,0,0,0,5,0,0,5,0,0,0,5,0,0,5,10
2022,Burundi,BDI,Cote d'Ivoire,CIV,0,0,7,9,0,0,16,0,7,0,11,0,0,18,34
2022,Benin,BEN,Cote d'Ivoire,CIV,0,0,0,0,0,0,0,0,0,0,5,0,0,5,5
2022,Burkina Faso,BFA,Cote d'Ivoire,CIV,284,406,195,780,104,0,1769,281,443,207,598,82,0,1611,3380
2022,Cambodia,KHM,Cote d'Ivoire,CIV,0,0,0,7,0,0,7,0,0,0,0,0,0,0,7
2022,Central African Rep.,CAF,Cote d'Ivoire,CIV,13,46,34,158,6,0,257,12,30,34,272,5,0,353,610
2022,Chad,TCD,Cote d'Ivoire,CIV,0,0,0,0,0,0,0,0,0,0,11,0,0,11,11
2022,Cameroon,CMR,Cote d'Ivoire,CIV,0,5,0,9,0,0,14,0,7,0,15,0,0,22,36
2022,Congo,COG,Cote d'Ivoire,CIV,0,6,12,9,5,0,32,8,6,9,28,5,0,56,88
2022,Dem. Rep. of the Congo,COD,Cote d'Ivoire,CIV,5,12,5,42,7,0,71,6,0,8,49,6,0,69,140
2022,Eritrea,ERI,Cote d'Ivoire,CIV,0,0,0,8,0,0,8,0,0,0,0,0,0,0,8
2022,Ethiopia,ETH,Cote d'Ivoire,CIV,0,7,0,0,0,0,7,0,0,0,5,0,0,5,12
2022,Iran (Islamic Rep. of),IRN,Cote d'Ivoire,CIV,0,0,0,0,0,0,0,0,0,0,7,0,0,7,7
2022,Iraq,IRQ,Cote d'Ivoire,CIV,0,0,0,5,0,0,5,0,0,0,0,0,0,0,5
2022,Liberia,LBR,Cote d'Ivoire,CIV,50,94,81,318,25,0,568,54,77,91,276,20,0,518,1086
2022,Lebanon,LBN,Cote d'Ivoire,CIV,0,0,0,5,0,0,5,0,0,0,0,0,0,0,5
2022,Mauritania,MRT,Cote d'Ivoire,CIV,0,0,0,5,0,0,5,0,0,0,5,0,0,5,10
2022,Mali,MLI,Cote d'Ivoire,CIV,0,13,0,0,0,0,13,0,8,0,17,0,0,25,38
2022,Niger,NER,Cote d'Ivoire,CIV,0,0,0,0,0,0,0,0,5,0,0,0,0,5,5
2022,Nigeria,NGA,Cote d'Ivoire,CIV,0,0,0,5,0,0,5,0,0,0,6,0,0,6,11
2022,Rwanda,RWA,Cote d'Ivoire,CIV,0,0,9,14,5,0,28,0,6,0,17,5,0,28,56
2022,Senegal,SEN,Cote d'Ivoire,CIV,5,0,0,0,0,0,5,0,0,0,0,0,0,0,5
2022,Somalia,SOM,Cote d'Ivoire,CIV,0,5,0,0,0,0,5,0,0,0,5,0,0,5,10
2022,Viet Nam,VNM,Cote d'Ivoire,CIV,0,0,0,0,5,0,5,0,0,0,0,0,0,0,5
2022,Sudan,SDN,Cote d'Ivoire,CIV,0,0,0,0,0,0,0,0,0,9,0,0,0,9,9
2022,Syrian Arab Rep.,SYR,Cote d'Ivoire,CIV,8,13,6,33,0,0,60,6,7,12,66,6,0,97,157
2022,Togo,TGO,Cote d'Ivoire,CIV,0,0,0,6,0,0,6,0,0,5,12,0,0,17,23
2022,Türkiye,TUR,Cote d'Ivoire,CIV,0,6,0,9,0,0,15,0,9,0,10,0,0,19,34
2022,Yemen,YEM,Cote d'Ivoire,CIV,0,0,0,0,0,0,0,0,0,0,5,0,0,5,5
2022,Afghanistan,AFG,India,IND,406,968,922,4423,384,0,7103,411,1085,978,5063,399,0,7936,15039
2022,Egypt,EGY,India,IND,0,0,0,0,0,0,0,0,0,0,6,0,0,6,6
2022,Burundi,BDI,India,IND,0,0,0,0,0,0,0,0,0,0,5,0,0,5,5
2022,Bangladesh,BGD,India,IND,0,0,0,8,0,0,8,0,0,0,0,0,0,0,8
2022,Bosnia and Herzegovina,BIH,India,IND,0,5,0,0,0,0,5,0,0,0,0,0,0,0,5
2022,China,CHN,India,IND,0,0,0,0,0,0,0,0,0,0,5,0,0,5,72294
2022,Cameroon,CMR,India,IND,5,0,0,150,0,0,155,5,0,0,121,0,0,126,281
2022,Congo,COG,India,IND,0,0,0,11,0,0,11,0,0,5,25,0,0,30,41
2022,Dem. Rep. of the Congo,COD,India,IND,14,10,10,64,0,0,98,19,5,0,104,0,0,128,226
2022,Eritrea,ERI,India,IND,0,0,0,0,0,0,0,0,0,0,27,0,0,27,27
2022,Ethiopia,ETH,India,IND,0,9,6,22,0,0,37,0,9,0,47,0,0,56,93
2022,Palestinian,PSE,India,IND,0,0,6,11,5,0,22,0,5,6,29,0,0,40,62
2022,Ghana,GHA,India,IND,0,0,0,12,0,0,12,0,0,0,54,0,0,54,66
2022,Guinea,GIN,India,IND,0,0,0,5,0,0,5,0,0,0,6,0,0,6,11
2022,Cote d'Ivoire,CIV,India,IND,5,0,0,34,0,0,39,5,0,0,141,0,0,146,185
2022,Iran (Islamic Rep. of),IRN,India,IND,0,12,7,50,5,0,74,0,0,7,67,12,0,86,160
2022,Iraq,IRQ,India,IND,0,7,13,41,5,0,66,0,0,9,97,6,0,112,178
2022,Kenya,KEN,India,IND,0,0,0,29,0,0,29,0,0,0,5,0,0,5,34
2022,Liberia,LBR,India,IND,0,0,0,0,0,0,0,0,0,0,5,0,0,5,5
2022,Libya,LBY,India,IND,0,0,0,0,0,0,0,0,0,0,14,0,0,14,14
2022,Sri Lanka,LKA,India,IND,0,0,0,0,0,29863,29863,0,0,0,0,0,28619,28619,92072
2022,Maldives,MDV,India,IND,0,0,5,0,0,0,5,0,0,0,0,0,0,0,5
2022,Myanmar,MMR,India,IND,1856,2681,1599,7279,311,0,13726,1893,2803,1774,8814,348,0,15632,74607
2022,Nigeria,NGA,India,IND,21,19,5,98,0,0,143,19,25,5,365,0,0,414,557
2022,Russian Federation,RUS,India,IND,0,0,0,6,5,0,11,0,0,0,23,0,0,23,34
2022,Rwanda,RWA,India,IND,0,0,0,5,0,0,5,0,5,0,5,0,0,10,15
2022,Saudi Arabia,SAU,India,IND,0,5,0,0,0,0,5,0,0,0,0,0,0,0,5
2022,Senegal,SEN,India,IND,0,0,0,5,0,0,5,0,0,0,23,0,0,23,28
2022,Sierra Leone,SLE,India,IND,0,0,0,0,0,0,0,0,0,0,8,0,0,8,8
2022,Somalia,SOM,India,IND,38,36,45,287,13,0,419,26,39,36,358,0,0,459,878
2022,South Sudan,SSD,India,IND,0,0,0,15,0,0,15,0,0,0,95,0,0,95,110
2022,Sudan,SDN,India,IND,0,6,0,32,0,0,38,7,0,12,194,0,0,213,251
2022,Syrian Arab Rep.,SYR,India,IND,5,11,10,28,0,0,54,7,8,5,71,0,0,91,145
2022,United Rep. of Tanzania,TZA,India,IND,0,0,0,12,0,0,12,0,0,0,0,0,0,0,12
2022,Tajikistan,TJK,India,IND,0,0,0,5,0,0,5,0,0,0,0,0,0,0,5
2022,Türkiye,TUR,India,IND,0,0,0,0,0,0,0,0,0,0,5,0,0,5,5
2022,Uganda,UGA,India,IND,6,0,0,25,0,0,31,0,0,0,7,0,0,7,38
2022,Ukraine,UKR,India,IND,0,0,5,27,0,0,32,0,5,0,21,0,0,26,58
2022,Uzbekistan,UZB,India,IND,0,0,0,12,0,0,12,0,0,0,0,0,0,0,12
2022,Venezuela (Bolivarian Republic of),VEN,India,IND,0,0,0,11,0,0,11,0,0,0,0,0,0,0,11
2022,Yemen,YEM,India,IND,29,58,32,226,23,0,368,29,69,51,507,9,0,665,1033
2022,Afghanistan,AFG,Indonesia,IDN,203,311,229,1061,75,0,1879,196,356,290,4203,67,0,5112,6991
2022,Angola,AGO,Indonesia,IDN,0,0,7,0,0,0,7,0,0,0,0,0,0,0,7
2022,Egypt,EGY,Indonesia,IDN,0,5,0,5,0,0,10,0,0,0,17,5,0,22,32
2022,China,CHN,Indonesia,IDN,0,0,0,10,0,0,10,0,0,5,5,0,0,10,20
2022,Cameroon,CMR,Indonesia,IDN,0,0,0,5,0,0,5,0,0,0,14,0,0,14,19
2022,Dem. Rep. of the Congo,COD,Indonesia,IDN,0,0,5,0,0,0,5,0,0,0,5,0,0,5,10
2022,Eritrea,ERI,Indonesia,IDN,0,16,22,79,5,0,122,19,22,18,59,0,0,118,240
2022,Ethiopia,ETH,Indonesia,IDN,14,16,11,33,0,0,74,5,13,6,45,0,0,69,143
2022,Palestinian,PSE,Indonesia,IDN,0,17,21,38,0,0,76,0,25,7,103,10,0,145,221
2022,Cote d'Ivoire,CIV,Indonesia,IDN,0,0,0,5,0,0,5,0,0,0,5,0,0,5,10
2022,Iran (Islamic Rep. of),IRN,Indonesia,IDN,5,11,6,88,0,0,110,5,12,10,172,0,0,199,309
2022,Iraq,IRQ,Indonesia,IDN,19,25,72,125,10,0,251,8,58,61,237,8,0,372,623
2022,Kuwait,KWT,Indonesia,IDN,0,0,0,0,0,0,0,0,0,0,5,0,0,5,5
2022,Liberia,LBR,Indonesia,IDN,0,0,0,0,0,0,0,0,0,0,7,0,0,7,7
2022,Libya,LBY,Indonesia,IDN,0,5,0,0,0,0,5,0,0,5,5,0,0,10,15
2022,Sri Lanka,LKA,Indonesia,IDN,14,44,33,106,5,0,202,9,35,23,166,0,0,233,435
2022,Mali,MLI,Indonesia,IDN,0,0,0,0,0,0,0,0,0,0,5,0,0,5,5
2022,Mozambique,MOZ,Indonesia,IDN,0,0,0,0,0,0,0,0,0,0,5,0,0,5,5
2022,Myanmar,MMR,Indonesia,IDN,17,59,57,158,5,0,296,31,40,78,460,5,0,614,910
2022,Nigeria,NGA,Indonesia,IDN,0,0,0,0,0,0,0,0,0,0,7,0,0,7,7
2022,Pakistan,PAK,Indonesia,IDN,7,0,12,39,5,0,63,5,11,5,214,0,0,235,298
2022,Russian Federation,RUS,Indonesia,IDN,0,0,0,0,0,0,0,0,0,5,5,0,0,10,10
2022,Saudi Arabia,SAU,Indonesia,IDN,0,0,8,0,0,0,8,0,0,0,0,0,0,0,8
2022,Sierra Leone,SLE,Indonesia,IDN,0,0,0,0,0,0,0,0,0,0,5,0,0,5,5
2022,Somalia,SOM,Indonesia,IDN,83,86,34,355,10,0,568,128,86,38,487,0,0,739,1307
2022,Sudan,SDN,Indonesia,IDN,40,21,13,76,0,0,150,45,39,7,262,0,0,353,503
2022,Syrian Arab Rep.,SYR,Indonesia,IDN,0,9,0,5,0,0,14,5,0,0,25,0,0,30,44
2022,United Rep. of Tanzania,TZA,Indonesia,IDN,0,0,0,5,0,0,5,0,0,0,0,0,0,0,5
2022,Türkiye,TUR,Indonesia,IDN,0,7,0,0,0,0,7,0,0,0,0,0,0,0,7
2022,Uganda,UGA,Indonesia,IDN,0,0,0,18,0,0,18,5,0,0,0,0,0,5,23
2022,Venezuela (Bolivarian Republic of),VEN,Indonesia,IDN,0,0,0,0,0,0,0,0,0,0,5,0,0,5,5
2022,Yemen,YEM,Indonesia,IDN,7,20,19,131,10,0,187,19,42,35,157,5,0,258,445
2022,Afghanistan,AFG,Ireland,IRL,0,13,10,24,6,0,53,0,18,103,1314,5,0,1440,2070
2022,Albania,ALB,Ireland,IRL,29,22,14,139,0,0,204,29,27,20,322,5,0,403,607
2022,Algeria,DZA,Ireland,IRL,46,43,5,191,0,0,285,39,44,17,1614,0,0,1714,1999
2022,Angola,AGO,Ireland,IRL,0,5,5,22,0,0,32,0,0,8,46,0,0,54,86
2022,Egypt,EGY,Ireland,IRL,0,0,9,17,0,0,26,0,0,14,373,0,0,387,413
2022,Armenia,ARM,Ireland,IRL,0,0,0,5,0,0,5,0,0,6,0,0,0,6,11
2022,Azerbaijan,AZE,Ireland,IRL,0,0,0,7,0,0,7,0,0,0,5,0,0,5,12
2022,Bahrain,BHR,Ireland,IRL,0,0,0,0,0,0,0,0,0,5,7,0,0,12,12
2022,Burundi,BDI,Ireland,IRL,0,0,0,11,0,0,11,0,0,0,27,0,0,27,38
2022,Benin,BEN,Ireland,IRL,0,5,0,0,0,0,5,0,0,0,0,0,0,0,5
2022,Bangladesh,BGD,Ireland,IRL,12,17,0,69,0,0,98,15,17,5,162,5,0,204,302
2022,Bhutan,BTN,Ireland,IRL,0,0,0,0,0,0,0,0,0,0,8,0,0,8,8
2022,Belarus,BLR,Ireland,IRL,0,0,0,18,0,0,18,0,0,0,25,0,0,25,43
2022,Bolivia (Plurinational State of),BOL,Ireland,IRL,8,7,0,37,0,0,52,0,13,0,19,0,0,32,84
2022,Botswana,BWA,Ireland,IRL,5,17,6,230,0,0,258,9,13,18,127,0,0,167,425
2022,Brazil,BRA,Ireland,IRL,0,12,0,60,0,0,72,8,11,5,76,0,0,100,172
2022,Chad,TCD,Ireland,IRL,0,0,0,0,0,0,0,0,0,0,5,0,0,5,5
2022,China,CHN,Ireland,IRL,0,7,0,28,5,0,40,0,12,0,39,0,0,51,91
2022,Chile,CHL,Ireland,IRL,0,0,0,0,0,0,0,0,0,0,5,0,0,5,5
2022,Cameroon,CMR,Ireland,IRL,0,5,5,50,5,0,65,5,5,5,60,0,0,75,140
2022,Congo,COG,Ireland,IRL,0,0,0,7,0,0,7,0,0,0,11,0,0,11,18
2022,Dem. Rep. of the Congo,COD,Ireland,IRL,17,32,30,210,5,0,294,18,44,32,247,7,0,348,642
2022,Cuba,CUB,Ireland,IRL,0,0,0,0,0,0,0,0,0,0,6,0,0,6,6
2022,Dominica,DMA,Ireland,IRL,0,5,0,0,0,0,5,0,0,0,0,0,0,0,5
2022,Dominican Rep.,DOM,Ireland,IRL,0,0,0,0,0,0,0,5,0,0,0,0,0,5,5
2022,Eritrea,ERI,Ireland,IRL,0,0,6,29,5,0,40,0,0,5,89,0,0,94,134
2022,Ethiopia,ETH,Ireland,IRL,0,6,0,60,0,0,66,5,0,0,82,0,0,87,153
2022,Gambia,GMB,Ireland,IRL,0,0,0,5,0,0,5,0,0,0,5,0,0,5,10
2022,Palestinian,PSE,Ireland,IRL,0,9,0,34,0,0,43,5,8,12,95,5,0,125,168
2022,United Kingdom of Great Britain and Northern Ireland,GBR,Ireland,IRL,0,0,0,0,0,0,0,0,0,0,6,0,0,6,6
2022,Georgia,GEO,Ireland,IRL,61,58,37,737,17,0,910,64,68,44,2134,10,0,2320,3230
2022,Ghana,GHA,Ireland,IRL,8,0,5,28,0,0,41,0,10,0,71,0,0,81,122
2022,Guatemala,GTM,Ireland,IRL,0,0,0,14,0,0,14,0,0,6,11,0,0,17,31
2022,Guinea,GIN,Ireland,IRL,0,0,0,5,0,0,5,0,0,0,14,0,0,14,19
2022,Guyana,GUY,Ireland,IRL,0,0,0,0,0,0,0,0,0,0,5,0,0,5,5
2022,Honduras,HND,Ireland,IRL,0,0,0,11,0,0,11,0,0,0,6,0,0,6,17
2022,Cote d'Ivoire,CIV,Ireland,IRL,0,0,0,11,0,0,11,0,0,0,14,0,0,14,25
2022,India,IND,Ireland,IRL,10,0,0,23,0,0,33,7,0,0,54,0,0,61,94
2022,Indonesia,IDN,Ireland,IRL,0,0,0,5,0,0,5,0,0,0,5,0,0,5,10
2022,Iran (Islamic Rep. of),IRN,Ireland,IRL,0,6,5,35,6,0,52,0,0,10,123,5,0,138,190
2022,Iraq,IRQ,Ireland,IRL,5,15,34,74,15,0,143,5,23,35,199,9,0,271,445
2022,Israel,ISR,Ireland,IRL,0,0,0,5,0,0,5,0,0,6,7,0,0,13,18
2022,Jordan,JOR,Ireland,IRL,0,0,0,14,0,0,14,10,0,0,22,0,0,32,46
2022,Kazakhstan,KAZ,Ireland,IRL,0,0,0,5,0,0,5,0,5,0,6,0,0,11,16
2022,Kenya,KEN,Ireland,IRL,0,14,0,48,0,0,62,0,5,5,28,0,0,38,100
2022,Dem. People's Rep. of Korea,PRK,Ireland,IRL,0,0,5,8,0,0,13,0,0,0,0,0,0,0,13
2022,Kuwait,KWT,Ireland,IRL,0,0,0,13,5,0,18,0,0,5,39,0,0,44,62
2022,Liberia,LBR,Ireland,IRL,0,0,0,7,0,0,7,0,0,0,5,0,0,5,12
2022,Libya,LBY,Ireland,IRL,0,20,11,25,0,0,56,6,30,11,113,0,0,160,216
2022,Lebanon,LBN,Ireland,IRL,0,5,5,0,0,0,10,0,5,0,17,0,0,22,32
2022,Lesotho,LSO,Ireland,IRL,7,0,0,5,0,0,12,0,0,0,0,0,0,0,12
2022,Sri Lanka,LKA,Ireland,IRL,0,0,0,6,0,0,6,0,5,0,17,0,0,22,28
2022,North Macedonia,MKD,Ireland,IRL,0,0,0,6,0,0,6,0,0,0,0,0,0,0,6
2022,Rep. of Moldova,MDA,Ireland,IRL,0,0,5,12,0,0,17,0,0,0,25,0,0,25,42
2022,Mexico,MEX,Ireland,IRL,0,0,0,10,0,0,10,0,0,0,5,0,0,5,15
2022,Malaysia,MYS,Ireland,IRL,0,5,0,8,0,0,13,0,5,0,21,0,0,26,39
2022,Malawi,MWI,Ireland,IRL,14,21,5,119,0,0,159,10,11,5,91,0,0,117,276
2022,Montenegro,MNE,Ireland,IRL,0,0,0,0,0,0,0,0,0,0,5,0,0,5,5
2022,Mongolia,MNG,Ireland,IRL,9,0,0,0,0,0,9,0,0,0,0,0,0,0,9
2022,Morocco,MAR,Ireland,IRL,5,7,0,32,0,0,44,14,0,0,174,0,0,188,232
2022,Mozambique,MOZ,Ireland,IRL,0,0,0,5,0,0,5,0,0,0,6,0,0,6,11
2022,Mauritius,MUS,Ireland,IRL,0,5,0,22,0,0,27,0,10,0,15,0,0,25,52
2022,Myanmar,MMR,Ireland,IRL,0,0,0,9,0,0,9,0,0,0,9,0,0,9,23
2022,Nepal,NPL,Ireland,IRL,0,0,0,12,0,0,12,0,0,0,34,0,0,34,46
2022,Nicaragua,NIC,Ireland,IRL,0,11,0,29,0,0,40,5,0,7,36,0,0,48,88
2022,Nigeria,NGA,Ireland,IRL,102,139,81,580,17,0,919,104,151,80,641,10,0,986,1910
2022,Pakistan,PAK,Ireland,IRL,18,41,32,161,11,0,263,27,31,19,421,11,0,509,772
2022,Panama,PAN,Ireland,IRL,0,0,0,7,0,0,7,0,0,0,0,0,0,0,7
2022,Philippines,PHL,Ireland,IRL,0,5,0,5,0,0,10,0,0,0,0,0,0,0,10
2022,South Africa,ZAF,Ireland,IRL,26,46,54,254,15,0,395,23,57,47,199,5,0,331,726
2022,Russian Federation,RUS,Ireland,IRL,0,5,5,44,5,0,59,0,10,0,61,5,0,76,135
2022,Rwanda,RWA,Ireland,IRL,0,0,0,15,0,0,15,0,0,5,13,0,0,18,33
2022,El Salvador,SLV,Ireland,IRL,6,7,5,87,5,0,110,5,12,11,112,0,0,140,250
2022,Saudi Arabia,SAU,Ireland,IRL,0,0,0,22,0,0,22,0,0,5,6,0,0,11,33
2022,Senegal,SEN,Ireland,IRL,0,0,0,6,0,0,6,0,0,0,5,0,0,5,11
2022,Sierra Leone,SLE,Ireland,IRL,6,6,5,59,0,0,76,0,15,0,67,0,0,82,158
2022,Somalia,SOM,Ireland,IRL,36,23,70,729,11,0,869,46,33,55,1291,17,0,1442,2311
2022,Serbia and Kosovo: S/RES/1244 (1999),SRB,Ireland,IRL,0,0,0,24,0,0,24,0,0,0,37,5,0,42,66
2022,Viet Nam,VNM,Ireland,IRL,0,0,0,14,0,0,14,0,0,0,28,0,0,28,42
2022,South Sudan,SSD,Ireland,IRL,0,0,0,0,0,0,0,0,0,0,6,0,0,6,6
2022,Stateless,XXA,Ireland,IRL,0,9,0,0,0,0,9,0,0,0,12,0,0,12,21
2022,Sudan,SDN,Ireland,IRL,0,11,9,41,0,0,61,14,5,7,208,5,0,239,300
2022,Eswatini,SWZ,Ireland,IRL,6,0,0,29,0,0,35,0,5,11,35,0,0,51,86
2022,Syrian Arab Rep.,SYR,Ireland,IRL,18,133,72,203,17,0,443,5,136,68,397,10,0,616,2607
2022,United Rep. of Tanzania,TZA,Ireland,IRL,0,0,0,6,0,0,6,0,0,0,5,0,0,5,11
2022,Turks and Caicos Islands,TCA,Ireland,IRL,5,0,0,0,0,0,5,0,0,0,0,0,0,0,5
2022,Togo,TGO,Ireland,IRL,0,0,5,9,0,0,14,0,0,0,49,0,0,49,63
2022,Trinidad and Tobago,TTO,Ireland,IRL,0,0,0,5,0,0,5,0,0,0,0,0,0,0,5
2022,Tunisia,TUN,Ireland,IRL,5,0,0,7,0,0,12,6,0,0,41,0,0,47,59
2022,Türkiye,TUR,Ireland,IRL,0,0,0,24,0,0,24,0,0,6,46,0,0,52,76
2022,Uganda,UGA,Ireland,IRL,0,0,5,42,0,0,47,0,10,0,41,0,0,51,98
2022,Unknown ,UNK,Ireland,IRL,0,0,0,0,0,0,0,0,0,0,0,0,0,0,269
2022,Ukraine,UKR,Ireland,IRL,6,16,15,100,18,0,155,10,19,16,110,11,0,166,70816
2022,United States of America,USA,Ireland,IRL,0,0,0,12,0,0,12,0,0,5,5,0,0,10,22
2022,Uzbekistan,UZB,Ireland,IRL,0,0,0,0,0,0,0,0,0,0,12,0,0,12,12
2022,Venezuela (Bolivarian Republic of),VEN,Ireland,IRL,0,5,5,71,18,0,99,5,0,5,96,5,0,111,210
2022,Yemen,YEM,Ireland,IRL,5,5,0,13,0,0,23,0,5,5,39,0,0,49,72
2022,Zambia,ZMB,Ireland,IRL,0,0,0,5,0,0,5,0,0,5,0,0,0,5,10
2022,Zimbabwe,ZWE,Ireland,IRL,59,111,82,791,10,0,1053,47,88,63,634,5,0,837,1890
2022,Afghanistan,AFG,Iran (Islamic Rep. of),IRN,230021,314576,217038,796047,67833,0,1625515,237954,330572,235234,884325,99649,0,1787734,3413249
2022,Iraq,IRQ,Iran (Islamic Rep. of),IRN,705,946,580,3207,461,0,5899,739,985,618,2994,582,0,5918,11817
2022,Kuwait,KWT,Iran (Islamic Rep. of),IRN,0,0,0,8,0,0,8,0,0,0,0,0,0,0,8
2022,Myanmar,MMR,Iran (Islamic Rep. of),IRN,0,0,12,6,0,0,18,0,8,0,8,0,0,16,34
2022,Pakistan,PAK,Iran (Islamic Rep. of),IRN,0,0,0,5,0,0,5,0,0,0,5,0,0,5,10
2022,Uzbekistan,UZB,Iran (Islamic Rep. of),IRN,0,0,0,0,0,0,0,0,0,0,7,0,0,7,7
2022,Afghanistan,AFG,Iraq,IRQ,25,42,32,118,11,0,228,32,34,45,298,12,0,421,649
2022,Egypt,EGY,Iraq,IRQ,0,7,0,0,0,0,7,0,0,0,23,11,0,34,41
2022,Bahrain,BHR,Iraq,IRQ,0,0,0,0,5,0,5,0,0,0,17,5,0,22,27
2022,Bangladesh,BGD,Iraq,IRQ,0,0,0,0,0,0,0,0,0,0,5,0,0,5,5
2022,Eritrea,ERI,Iraq,IRQ,0,0,11,6,0,0,17,0,0,6,7,5,0,18,35
2022,Ethiopia,ETH,Iraq,IRQ,0,0,0,0,0,0,0,0,5,0,5,0,0,10,10
2022,Palestinian,PSE,Iraq,IRQ,157,447,326,2381,650,0,3961,209,425,354,2273,655,0,3916,7877
2022,Iran (Islamic Rep. of),IRN,Iraq,IRQ,155,465,434,2919,295,0,4268,172,505,450,2760,305,0,4192,8460
2022,Jordan,JOR,Iraq,IRQ,0,5,0,0,0,0,5,0,0,0,0,0,0,0,5
2022,Kazakhstan,KAZ,Iraq,IRQ,0,0,0,5,0,0,5,0,0,0,0,0,0,0,5
2022,Kyrgyzstan,KGZ,Iraq,IRQ,0,0,10,0,0,0,10,0,5,0,0,0,0,5,15
2022,Kuwait,KWT,Iraq,IRQ,0,50,56,108,5,0,219,0,33,56,33,0,0,122,341
2022,Lebanon,LBN,Iraq,IRQ,0,0,0,23,0,0,23,0,11,0,11,0,0,22,45
2022,Pakistan,PAK,Iraq,IRQ,0,0,5,13,0,0,18,0,5,8,186,5,0,204,222
2022,Saudi Arabia,SAU,Iraq,IRQ,0,0,0,0,0,0,0,0,0,0,7,0,0,7,7
2022,Somalia,SOM,Iraq,IRQ,0,0,0,0,0,0,0,0,11,0,0,0,0,11,11
2022,South Sudan,SSD,Iraq,IRQ,0,0,0,0,0,0,0,0,0,6,0,9,0,15,15
2022,Sudan,SDN,Iraq,IRQ,21,46,31,90,0,0,188,15,40,43,197,480,0,775,963
2022,Syrian Arab Rep.,SYR,Iraq,IRQ,19360,24702,12586,60997,4807,0,122452,20301,25967,13667,71203,3849,0,134987,257439
2022,Tunisia,TUN,Iraq,IRQ,0,0,0,5,0,0,5,0,0,0,0,0,0,0,5
2022,Türkiye,TUR,Iraq,IRQ,282,689,610,1892,122,0,3595,316,745,617,2540,152,0,4370,7965
2022,Ukraine,UKR,Iraq,IRQ,0,0,0,5,0,0,5,0,0,0,0,0,0,0,5
2022,Yemen,YEM,Iraq,IRQ,7,0,10,47,5,0,69,5,13,19,79,5,0,121,190
2022,Albania,ALB,Israel,ISR,0,0,0,0,0,0,0,0,0,0,0,0,0,0,25
2022,Armenia,ARM,Israel,ISR,0,0,0,0,0,0,0,0,0,0,0,0,0,0,27
2022,Azerbaijan,AZE,Israel,ISR,0,0,0,0,0,0,0,0,0,0,0,0,0,0,34
2022,Benin,BEN,Israel,ISR,0,0,0,0,0,0,0,0,0,0,0,0,0,0,5
2022,Burkina Faso,BFA,Israel,ISR,0,0,0,0,0,0,0,0,0,0,0,0,0,0,9
2022,Belarus,BLR,Israel,ISR,0,0,0,0,0,0,0,0,0,0,0,0,0,0,849
2022,Botswana,BWA,Israel,ISR,0,0,0,0,0,0,0,0,0,0,0,0,0,0,5
2022,Brazil,BRA,Israel,ISR,0,0,0,0,0,0,0,0,0,0,0,0,0,0,5
2022,Bulgaria,BGR,Israel,ISR,0,0,0,0,0,0,0,0,0,0,0,0,0,0,5
2022,Cambodia,KHM,Israel,ISR,0,0,0,0,0,0,0,0,0,0,0,0,0,0,5
2022,Central African Rep.,CAF,Israel,ISR,0,0,0,0,0,0,0,0,0,0,0,0,0,0,14
2022,Chad,TCD,Israel,ISR,0,0,0,0,0,0,0,0,0,0,0,0,0,0,10
2022,China,CHN,Israel,ISR,0,0,0,0,0,0,0,0,0,0,0,0,0,0,428
2022,Cameroon,CMR,Israel,ISR,0,0,0,0,0,0,0,0,0,0,0,0,0,0,55
2022,Congo,COG,Israel,ISR,0,0,0,0,0,0,0,0,0,0,0,0,0,0,24
2022,Dem. Rep. of the Congo,COD,Israel,ISR,0,0,0,0,0,0,0,0,0,0,0,0,0,0,215
2022,Colombia,COL,Israel,ISR,0,0,0,0,0,0,0,0,0,0,0,0,0,0,129
2022,Ecuador,ECU,Israel,ISR,0,0,0,0,0,0,0,0,0,0,0,0,0,0,17
2022,Eritrea,ERI,Israel,ISR,0,0,0,0,0,0,0,0,0,0,0,0,0,0,9469
2022,Ethiopia,ETH,Israel,ISR,0,0,0,0,0,0,0,0,0,0,0,0,0,0,978
2022,Georgia,GEO,Israel,ISR,0,0,0,0,0,0,0,0,0,0,0,0,0,0,35
2022,Ghana,GHA,Israel,ISR,0,0,0,0,0,0,0,0,0,0,0,0,0,0,271
2022,Honduras,HND,Israel,ISR,0,0,0,0,0,0,0,0,0,0,0,0,0,0,5
2022,Cote d'Ivoire,CIV,Israel,ISR,0,0,0,0,0,0,0,0,0,0,0,0,0,0,24
2022,India,IND,Israel,ISR,0,0,0,0,0,0,0,0,0,0,0,0,0,0,950
2022,Iran (Islamic Rep. of),IRN,Israel,ISR,0,0,0,0,0,0,0,0,0,0,0,0,0,0,6
2022,Iraq,IRQ,Israel,ISR,0,0,0,0,0,0,0,0,0,0,0,0,0,0,10
2022,Kazakhstan,KAZ,Israel,ISR,0,0,0,0,0,0,0,0,0,0,0,0,0,0,96
2022,Kenya,KEN,Israel,ISR,0,0,0,0,0,0,0,0,0,0,0,0,0,0,133
2022,Kyrgyzstan,KGZ,Israel,ISR,0,0,0,0,0,0,0,0,0,0,0,0,0,0,32
2022,Dem. People's Rep. of Korea,PRK,Israel,ISR,0,0,0,0,0,0,0,0,0,0,0,0,0,0,5
2022,Liberia,LBR,Israel,ISR,0,0,0,0,0,0,0,0,0,0,0,0,0,0,5
2022,Lesotho,LSO,Israel,ISR,0,0,0,0,0,0,0,0,0,0,0,0,0,0,7
2022,Sri Lanka,LKA,Israel,ISR,0,0,0,0,0,0,0,0,0,0,0,0,0,0,911
2022,North Macedonia,MKD,Israel,ISR,0,0,0,0,0,0,0,0,0,0,0,0,0,0,39
2022,Rep. of Moldova,MDA,Israel,ISR,0,0,0,0,0,0,0,0,0,0,0,0,0,0,258
2022,Mexico,MEX,Israel,ISR,0,0,0,0,0,0,0,0,0,0,0,0,0,0,7
2022,Mali,MLI,Israel,ISR,0,0,0,0,0,0,0,0,0,0,0,0,0,0,5
2022,Malawi,MWI,Israel,ISR,0,0,0,0,0,0,0,0,0,0,0,0,0,0,76
2022,Montenegro,MNE,Israel,ISR,0,0,0,0,0,0,0,0,0,0,0,0,0,0,32
2022,Mozambique,MOZ,Israel,ISR,0,0,0,0,0,0,0,0,0,0,0,0,0,0,5
2022,Myanmar,MMR,Israel,ISR,0,0,0,0,0,0,0,0,0,0,0,0,0,0,217
2022,Nepal,NPL,Israel,ISR,0,0,0,0,0,0,0,0,0,0,0,0,0,0,102
2022,Nigeria,NGA,Israel,ISR,0,0,0,0,0,0,0,0,0,0,0,0,0,0,827
2022,Peru,PER,Israel,ISR,0,0,0,0,0,0,0,0,0,0,0,0,0,0,13
2022,Philippines,PHL,Israel,ISR,0,0,0,0,0,0,0,0,0,0,0,0,0,0,69
2022,Romania,ROU,Israel,ISR,0,0,0,0,0,0,0,0,0,0,0,0,0,0,18
2022,South Africa,ZAF,Israel,ISR,0,0,0,0,0,0,0,0,0,0,0,0,0,0,278
2022,Russian Federation,RUS,Israel,ISR,0,0,0,0,0,0,0,0,0,0,0,0,0,0,3042
2022,Rwanda,RWA,Israel,ISR,0,0,0,0,0,0,0,0,0,0,0,0,0,0,69
2022,Sierra Leone,SLE,Israel,ISR,0,0,0,0,0,0,0,0,0,0,0,0,0,0,16
2022,Somalia,SOM,Israel,ISR,0,0,0,0,0,0,0,0,0,0,0,0,0,0,11
2022,Spain,ESP,Israel,ISR,0,0,0,0,0,0,0,0,0,0,0,0,0,0,5
2022,Serbia and Kosovo: S/RES/1244 (1999),SRB,Israel,ISR,0,0,0,0,0,0,0,0,0,0,0,0,0,0,107
2022,Viet Nam,VNM,Israel,ISR,0,0,0,0,0,0,0,0,0,0,0,0,0,0,15
2022,South Sudan,SSD,Israel,ISR,0,0,0,0,0,0,0,0,0,0,0,0,0,0,124
2022,Sudan,SDN,Israel,ISR,0,0,0,0,0,0,0,0,0,0,0,0,0,0,4914
2022,United Rep. of Tanzania,TZA,Israel,ISR,0,0,0,0,0,0,0,0,0,0,0,0,0,0,8
2022,Thailand,THA,Israel,ISR,0,0,0,0,0,0,0,0,0,0,0,0,0,0,5
2022,Tajikistan,TJK,Israel,ISR,0,0,0,0,0,0,0,0,0,0,0,0,0,0,5
2022,Turkmenistan,TKM,Israel,ISR,0,0,0,0,0,0,0,0,0,0,0,0,0,0,5
2022,Togo,TGO,Israel,ISR,0,0,0,0,0,0,0,0,0,0,0,0,0,0,6
2022,Türkiye,TUR,Israel,ISR,0,0,0,0,0,0,0,0,0,0,0,0,0,0,162
2022,Uganda,UGA,Israel,ISR,0,0,0,0,0,0,0,0,0,0,0,0,0,0,261
2022,Unknown ,UNK,Israel,ISR,0,0,0,0,0,0,0,0,0,0,0,0,0,0,245
2022,Ukraine,UKR,Israel,ISR,0,0,0,0,0,0,0,0,0,0,0,0,0,0,414
2022,Uzbekistan,UZB,Israel,ISR,0,0,0,0,0,0,0,0,0,0,0,0,0,0,190
2022,Zambia,ZMB,Israel,ISR,0,0,0,0,0,0,0,0,0,0,0,0,0,0,5
2022,Zimbabwe,ZWE,Israel,ISR,0,0,0,0,0,0,0,0,0,0,0,0,0,0,20
2022,Afghanistan,AFG,Italy,ITA,0,0,0,0,0,241,241,0,0,0,0,0,1677,1677,20285
2022,Albania,ALB,Italy,ITA,0,0,0,0,0,181,181,0,0,0,0,0,350,350,1422
2022,Algeria,DZA,Italy,ITA,0,0,0,0,0,21,21,0,0,0,0,0,120,120,179
2022,Angola,AGO,Italy,ITA,0,0,0,0,0,5,5,0,0,0,0,0,8,8,18
2022,Egypt,EGY,Italy,ITA,0,0,0,0,0,60,60,0,0,0,0,0,7365,7365,8201
2022,Argentina,ARG,Italy,ITA,0,0,0,0,0,37,37,0,0,0,0,0,25,25,75
2022,Armenia,ARM,Italy,ITA,0,0,0,0,0,50,50,0,0,0,0,0,58,58,332
2022,Azerbaijan,AZE,Italy,ITA,0,0,0,0,0,16,16,0,0,0,0,0,26,26,59
2022,Burundi,BDI,Italy,ITA,0,0,0,0,0,0,0,0,0,0,0,0,0,0,6
2022,Benin,BEN,Italy,ITA,0,0,0,0,0,6,6,0,0,0,0,0,55,55,226
2022,Bangladesh,BGD,Italy,ITA,0,0,0,0,0,40,40,0,0,0,0,0,13238,13238,18421
2022,Burkina Faso,BFA,Italy,ITA,0,0,0,0,0,25,25,0,0,0,0,0,268,268,1212
2022,Belarus,BLR,Italy,ITA,0,0,0,0,0,80,80,0,0,0,0,0,70,70,284
2022,Bolivia (Plurinational State of),BOL,Italy,ITA,0,0,0,0,0,8,8,0,0,0,0,0,0,0,13
2022,Brazil,BRA,Italy,ITA,0,0,0,0,0,140,140,0,0,0,0,0,190,190,741
2022,Bosnia and Herzegovina,BIH,Italy,ITA,0,0,0,0,0,45,45,0,0,0,0,0,34,34,113
2022,Canada,CAN,Italy,ITA,0,0,0,0,0,0,0,0,0,0,0,0,0,0,5
2022,Central African Rep.,CAF,Italy,ITA,0,0,0,0,0,0,0,0,0,0,0,0,0,0,24
2022,Chad,TCD,Italy,ITA,0,0,0,0,0,6,6,0,0,0,0,0,46,46,52
2022,China,CHN,Italy,ITA,0,0,0,0,0,82,82,0,0,0,0,0,102,102,646
2022,Chile,CHL,Italy,ITA,0,0,0,0,0,15,15,0,0,0,0,0,14,14,46
2022,Cameroon,CMR,Italy,ITA,0,0,0,0,0,195,195,0,0,0,0,0,427,427,2374
2022,Congo,COG,Italy,ITA,0,0,0,0,0,31,31,0,0,0,0,0,30,30,357
2022,Dem. Rep. of the Congo,COD,Italy,ITA,0,0,0,0,0,35,35,0,0,0,0,0,34,34,772
2022,Comoros,COM,Italy,ITA,0,0,0,0,0,0,0,0,0,0,0,0,0,0,5
2022,Colombia,COL,Italy,ITA,0,0,0,0,0,740,740,0,0,0,0,0,809,809,2643
2022,Costa Rica,CRI,Italy,ITA,0,0,0,0,0,14,14,0,0,0,0,0,5,5,19
2022,Cuba,CUB,Italy,ITA,0,0,0,0,0,100,100,0,0,0,0,0,145,145,315
2022,Cabo Verde,CPV,Italy,ITA,0,0,0,0,0,0,0,0,0,0,0,0,0,0,5
2022,Dominican Rep.,DOM,Italy,ITA,0,0,0,0,0,15,15,0,0,0,0,0,19,19,47
2022,Ecuador,ECU,Italy,ITA,0,0,0,0,0,30,30,0,0,0,0,0,29,29,76
2022,Eritrea,ERI,Italy,ITA,0,0,0,0,0,1310,1310,0,0,0,0,0,3885,3885,8372
2022,Ethiopia,ETH,Italy,ITA,0,0,0,0,0,35,35,0,0,0,0,0,49,49,1064
2022,Gabon,GAB,Italy,ITA,0,0,0,0,0,0,0,0,0,0,0,0,0,0,6
2022,Gambia,GMB,Italy,ITA,0,0,0,0,0,20,20,0,0,0,0,0,794,794,6901
2022,Palestinian,PSE,Italy,ITA,0,0,0,0,0,21,21,0,0,0,0,0,105,105,868
2022,Georgia,GEO,Italy,ITA,0,0,0,0,0,2200,2200,0,0,0,0,0,524,524,3516
2022,Ghana,GHA,Italy,ITA,0,0,0,0,0,45,45,0,0,0,0,0,349,349,2867
2022,Guinea-Bissau,GNB,Italy,ITA,0,0,0,0,0,0,0,0,0,0,0,0,68,68,519
2022,Guatemala,GTM,Italy,ITA,0,0,0,0,0,10,10,0,0,0,0,0,10,10,36
2022,Guinea,GIN,Italy,ITA,0,0,0,0,0,155,155,0,0,0,0,0,822,822,3407
2022,Honduras,HND,Italy,ITA,0,0,0,0,0,89,89,0,0,0,0,0,74,74,656
2022,Cote d'Ivoire,CIV,Italy,ITA,0,0,0,0,0,770,770,0,0,0,0,0,1250,1250,5865
2022,India,IND,Italy,ITA,0,0,0,0,0,106,106,0,0,0,0,0,591,591,953
2022,Indonesia,IDN,Italy,ITA,0,0,0,0,0,0,0,0,0,0,0,0,0,0,5
2022,Iran (Islamic Rep. of),IRN,Italy,ITA,0,0,0,0,0,51,51,0,0,0,0,0,130,130,1394
2022,Iraq,IRQ,Italy,ITA,0,0,0,0,0,231,231,0,0,0,0,0,1006,1006,6826
2022,Israel,ISR,Italy,ITA,0,0,0,0,0,0,0,0,0,0,0,0,0,0,5
2022,Jordan,JOR,Italy,ITA,0,0,0,0,0,0,0,0,0,0,0,0,8,8,17
2022,Kazakhstan,KAZ,Italy,ITA,0,0,0,0,0,9,9,0,0,0,0,0,0,0,15
2022,Kenya,KEN,Italy,ITA,0,0,0,0,0,12,12,0,0,0,0,0,5,5,39
2022,Kyrgyzstan,KGZ,Italy,ITA,0,0,0,0,0,51,51,0,0,0,0,0,15,15,75
2022,Liberia,LBR,Italy,ITA,0,0,0,0,0,10,10,0,0,0,0,0,38,38,390
2022,Libya,LBY,Italy,ITA,0,0,0,0,0,51,51,0,0,0,0,0,190,190,1445
2022,Lebanon,LBN,Italy,ITA,0,0,0,0,0,50,50,0,0,0,0,0,80,80,136
2022,Liechtenstein,LIE,Italy,ITA,0,0,0,0,0,0,0,0,0,0,0,0,5,5,10
2022,Sri Lanka,LKA,Italy,ITA,0,0,0,0,0,115,115,0,0,0,0,0,339,339,803
2022,Madagascar,MDG,Italy,ITA,0,0,0,0,0,0,0,0,0,0,0,0,0,0,5
2022,Mauritania,MRT,Italy,ITA,0,0,0,0,0,0,0,0,0,0,0,0,9,9,248
2022,North Macedonia,MKD,Italy,ITA,0,0,0,0,0,21,21,0,0,0,0,0,40,40,76
2022,Rep. of Moldova,MDA,Italy,ITA,0,0,0,0,0,146,146,0,0,0,0,0,115,115,481
2022,Mexico,MEX,Italy,ITA,0,0,0,0,0,7,7,0,0,0,0,0,7,7,14
2022,Mali,MLI,Italy,ITA,0,0,0,0,0,50,50,0,0,0,0,0,1005,1005,11166
2022,Malaysia,MYS,Italy,ITA,0,0,0,0,0,0,0,0,0,0,0,0,0,0,5
2022,Montenegro,MNE,Italy,ITA,0,0,0,0,0,0,0,0,0,0,0,0,0,0,5
2022,Morocco,MAR,Italy,ITA,0,0,0,0,0,186,186,0,0,0,0,0,1593,1593,2788
2022,Mauritius,MUS,Italy,ITA,0,0,0,0,0,10,10,0,0,0,0,0,10,10,25
2022,Myanmar,MMR,Italy,ITA,0,0,0,0,0,6,6,0,0,0,0,0,5,5,25
2022,Nepal,NPL,Italy,ITA,0,0,0,0,0,30,30,0,0,0,0,0,85,85,140
2022,Niger,NER,Italy,ITA,0,0,0,0,0,0,0,0,0,0,0,0,43,43,491
2022,Nicaragua,NIC,Italy,ITA,0,0,0,0,0,15,15,0,0,0,0,0,15,15,45
2022,Nigeria,NGA,Italy,ITA,0,0,0,0,0,1775,1775,0,0,0,0,0,2688,2688,25409
2022,Pakistan,PAK,Italy,ITA,0,0,0,0,0,175,175,0,0,0,0,0,14142,14142,31420
2022,Panama,PAN,Italy,ITA,0,0,0,0,0,6,6,0,0,0,0,0,0,0,6
2022,Paraguay,PRY,Italy,ITA,0,0,0,0,0,17,17,0,0,0,0,0,11,11,28
2022,Peru,PER,Italy,ITA,0,0,0,0,0,1350,1350,0,0,0,0,0,1354,1354,3446
2022,Philippines,PHL,Italy,ITA,0,0,0,0,0,42,42,0,0,0,0,0,26,26,88
2022,South Africa,ZAF,Italy,ITA,0,0,0,0,0,6,6,0,0,0,0,0,6,6,17
2022,Russian Federation,RUS,Italy,ITA,0,0,0,0,0,302,302,0,0,0,0,0,285,285,1134
2022,Rwanda,RWA,Italy,ITA,0,0,0,0,0,0,0,0,0,0,0,0,0,0,5
2022,El Salvador,SLV,Italy,ITA,0,0,0,0,0,537,537,0,0,0,0,0,546,546,5167
2022,Senegal,SEN,Italy,ITA,0,0,0,0,0,65,65,0,0,0,0,0,532,532,5198
2022,Sierra Leone,SLE,Italy,ITA,0,0,0,0,0,36,36,0,0,0,0,0,140,140,598
2022,Somalia,SOM,Italy,ITA,0,0,0,0,0,181,181,0,0,0,0,0,780,780,9478
2022,Serbia and Kosovo: S/RES/1244 (1999),SRB,Italy,ITA,0,0,0,0,0,104,104,0,0,0,0,0,259,259,1720
2022,Viet Nam,VNM,Italy,ITA,0,0,0,0,0,0,0,0,0,0,0,0,0,0,6
2022,South Sudan,SSD,Italy,ITA,0,0,0,0,0,5,5,0,0,0,0,0,60,60,65
2022,Stateless,XXA,Italy,ITA,0,0,0,0,0,0,0,0,0,0,0,0,5,5,12
2022,Sudan,SDN,Italy,ITA,0,0,0,0,0,20,20,0,0,0,0,0,465,465,1580
2022,Syrian Arab Rep.,SYR,Italy,ITA,0,0,0,0,0,359,359,0,0,0,0,0,552,552,4489
2022,United Rep. of Tanzania,TZA,Italy,ITA,0,0,0,0,0,5,5,0,0,0,0,0,5,5,10
2022,Thailand,THA,Italy,ITA,0,0,0,0,0,8,8,0,0,0,0,0,0,0,8
2022,Tajikistan,TJK,Italy,ITA,0,0,0,0,0,0,0,0,0,0,0,0,0,0,5
2022,Turkmenistan,TKM,Italy,ITA,0,0,0,0,0,0,0,0,0,0,0,0,0,0,5
2022,Togo,TGO,Italy,ITA,0,0,0,0,0,16,16,0,0,0,0,0,90,90,829
2022,Tunisia,TUN,Italy,ITA,0,0,0,0,0,375,375,0,0,0,0,0,1545,1545,2497
2022,Türkiye,TUR,Italy,ITA,0,0,0,0,0,81,81,0,0,0,0,0,1076,1076,2764
2022,Uganda,UGA,Italy,ITA,0,0,0,0,0,7,7,0,0,0,0,0,5,5,17
2022,Unknown ,UNK,Italy,ITA,0,0,0,0,0,0,0,0,0,0,0,0,435,435,3081
2022,Ukraine,UKR,Italy,ITA,0,0,0,0,0,105478,105478,0,0,0,0,0,41405,41405,151750
2022,Uruguay,URY,Italy,ITA,0,0,0,0,0,0,0,0,0,0,0,0,0,0,10
2022,United States of America,USA,Italy,ITA,0,0,0,0,0,0,0,0,0,0,0,0,5,5,34
2022,Uzbekistan,UZB,Italy,ITA,0,0,0,0,0,8,8,0,0,0,0,0,0,0,18
2022,Venezuela (Bolivarian Republic of),VEN,Italy,ITA,0,0,0,0,0,605,605,0,0,0,0,0,479,479,4510
2022,Western Sahara,ESH,Italy,ITA,0,0,0,0,0,0,0,0,0,0,0,0,0,0,5
2022,Yemen,YEM,Italy,ITA,0,0,0,0,0,5,5,0,0,0,0,0,39,39,74
2022,Haiti,HTI,Jamaica,JAM,0,0,0,0,0,0,0,0,0,0,0,0,0,0,31
2022,Afghanistan,AFG,Jordan,JOR,0,0,0,0,0,0,0,0,0,0,16,0,0,16,16
2022,Algeria,DZA,Jordan,JOR,0,0,0,5,0,0,5,0,0,0,0,0,0,0,5
2022,Egypt,EGY,Jordan,JOR,21,42,68,114,0,0,245,7,80,44,157,11,0,299,544
2022,Bangladesh,BGD,Jordan,JOR,0,0,0,6,0,0,6,0,0,0,0,0,0,0,6
2022,Bosnia and Herzegovina,BIH,Jordan,JOR,0,0,0,0,0,0,0,0,0,0,9,0,0,9,9
2022,Central African Rep.,CAF,Jordan,JOR,0,0,0,0,0,0,0,0,0,0,7,0,0,7,7
2022,Chad,TCD,Jordan,JOR,5,0,0,6,0,0,11,0,0,0,11,0,0,11,22
2022,Comoros,COM,Jordan,JOR,0,0,0,0,0,0,0,0,0,0,5,0,0,5,5
2022,Eritrea,ERI,Jordan,JOR,0,6,5,7,0,0,18,0,7,0,18,0,0,25,43
2022,Ethiopia,ETH,Jordan,JOR,0,0,0,39,0,0,39,0,0,0,0,0,0,0,39
2022,India,IND,Jordan,JOR,0,0,0,5,0,0,5,0,0,0,0,0,0,0,5
2022,Iran (Islamic Rep. of),IRN,Jordan,JOR,0,0,0,0,0,0,0,0,0,0,5,0,0,5,5
2022,Iraq,IRQ,Jordan,JOR,504,3511,3853,17711,4422,0,30001,577,3777,4243,19744,3790,0,32131,62132
2022,Kenya,KEN,Jordan,JOR,0,0,0,10,0,0,10,0,0,0,0,0,0,0,10
2022,Libya,LBY,Jordan,JOR,0,23,26,40,0,0,89,0,12,17,35,0,0,64,153
2022,Lebanon,LBN,Jordan,JOR,0,12,12,37,10,0,71,0,7,5,17,0,0,29,100
2022,Sri Lanka,LKA,Jordan,JOR,0,0,0,9,0,0,9,0,0,0,0,0,0,0,9
2022,Morocco,MAR,Jordan,JOR,0,0,0,8,0,0,8,0,0,0,0,0,0,0,8
2022,Nigeria,NGA,Jordan,JOR,0,0,0,6,0,0,6,5,0,0,59,0,0,64,70
2022,Pakistan,PAK,Jordan,JOR,0,6,5,8,0,0,19,0,0,0,5,0,0,5,24
2022,Philippines,PHL,Jordan,JOR,0,0,0,5,0,0,5,0,0,0,0,0,0,0,5
2022,Russian Federation,RUS,Jordan,JOR,0,8,5,8,0,0,21,0,0,7,0,0,0,7,28
2022,Senegal,SEN,Jordan,JOR,0,0,0,0,0,0,0,0,5,0,0,0,0,5,5
2022,Somalia,SOM,Jordan,JOR,26,25,30,212,10,0,303,18,33,43,192,5,0,291,594
2022,South Sudan,SSD,Jordan,JOR,0,0,0,5,0,0,5,0,7,6,0,0,0,13,18
2022,Stateless,XXA,Jordan,JOR,0,7,11,29,0,0,47,0,0,5,12,0,0,17,64
2022,Sudan,SDN,Jordan,JOR,348,249,156,683,43,0,1479,404,242,166,2644,379,0,3835,5314
2022,Syrian Arab Rep.,SYR,Jordan,JOR,42426,67143,49294,156778,15705,0,331346,43796,71099,51789,151566,11296,0,329546,660892
2022,Tajikistan,TJK,Jordan,JOR,0,6,0,0,0,0,6,0,0,9,0,0,0,9,15
2022,Tunisia,TUN,Jordan,JOR,0,0,5,14,0,0,19,0,0,0,0,0,0,0,19
2022,Uganda,UGA,Jordan,JOR,0,0,0,5,0,0,5,0,0,0,0,0,0,0,5
2022,Ukraine,UKR,Jordan,JOR,0,0,0,5,0,0,5,0,5,0,0,0,0,5,10
2022,Venezuela (Bolivarian Republic of),VEN,Jordan,JOR,0,0,0,0,0,0,0,0,0,5,0,0,0,5,5
2022,Yemen,YEM,Jordan,JOR,640,576,367,2115,180,0,3878,665,562,386,6948,313,0,8874,12752
2022,Afghanistan,AFG,Japan,JPN,0,0,0,0,0,0,0,0,0,0,0,0,0,0,570
2022,Burundi,BDI,Japan,JPN,0,0,0,0,0,0,0,0,0,0,0,0,0,0,9
2022,Bangladesh,BGD,Japan,JPN,0,0,0,0,0,0,0,0,0,0,0,0,0,0,18
2022,China,CHN,Japan,JPN,0,0,0,0,0,0,0,0,0,0,0,0,0,0,86
2022,Cameroon,CMR,Japan,JPN,0,0,0,0,0,0,0,0,0,0,0,0,0,0,26
2022,Dem. Rep. of the Congo,COD,Japan,JPN,0,0,0,0,0,0,0,0,0,0,0,0,0,0,25
2022,Eritrea,ERI,Japan,JPN,0,0,0,0,0,0,0,0,0,0,0,0,0,0,5
2022,Ethiopia,ETH,Japan,JPN,0,0,0,0,0,0,0,0,0,0,0,0,0,0,36
2022,Guinea,GIN,Japan,JPN,0,0,0,0,0,0,0,0,0,0,0,0,0,0,5
2022,Iran (Islamic Rep. of),IRN,Japan,JPN,0,0,0,0,0,0,0,0,0,0,0,0,0,0,20
2022,Iraq,IRQ,Japan,JPN,0,0,0,0,0,0,0,0,0,0,0,0,0,0,17
2022,Sri Lanka,LKA,Japan,JPN,0,0,0,0,0,0,0,0,0,0,0,0,0,0,59
2022,Myanmar,MMR,Japan,JPN,0,0,0,0,0,0,0,0,0,0,0,0,0,0,13494
2022,Nigeria,NGA,Japan,JPN,0,0,0,0,0,0,0,0,0,0,0,0,0,0,6
2022,Pakistan,PAK,Japan,JPN,0,0,0,0,0,0,0,0,0,0,0,0,0,0,38
2022,Rwanda,RWA,Japan,JPN,0,0,0,0,0,0,0,0,0,0,0,0,0,0,5
2022,Somalia,SOM,Japan,JPN,0,0,0,0,0,0,0,0,0,0,0,0,0,0,5
2022,Stateless,XXA,Japan,JPN,0,0,0,0,0,0,0,0,0,0,0,0,0,0,9
2022,Sudan,SDN,Japan,JPN,0,0,0,0,0,0,0,0,0,0,0,0,0,0,16
2022,Syrian Arab Rep.,SYR,Japan,JPN,0,0,0,0,0,0,0,0,0,0,0,0,0,0,309
2022,Türkiye,TUR,Japan,JPN,0,0,0,0,0,0,0,0,0,0,0,0,0,0,47
2022,Uganda,UGA,Japan,JPN,0,0,0,0,0,0,0,0,0,0,0,0,0,0,8
2022,Unknown ,UNK,Japan,JPN,0,0,0,0,0,2744,2744,0,0,0,0,0,9729,9729,12809
2022,Ukraine,UKR,Japan,JPN,0,0,0,0,0,0,0,0,0,0,0,0,0,0,2238
2022,Yemen,YEM,Japan,JPN,0,0,0,0,0,0,0,0,0,0,0,0,0,0,19
2022,Afghanistan,AFG,Kazakhstan,KAZ,27,26,20,143,15,0,231,16,22,31,205,15,0,289,520
2022,China,CHN,Kazakhstan,KAZ,0,0,6,5,0,0,11,0,0,6,0,0,0,6,17
2022,Iran (Islamic Rep. of),IRN,Kazakhstan,KAZ,0,0,5,0,0,0,5,0,0,0,0,0,0,0,5
2022,Russian Federation,RUS,Kazakhstan,KAZ,0,0,0,6,0,0,6,0,0,5,12,0,0,17,23
2022,Saudi Arabia,SAU,Kazakhstan,KAZ,0,0,0,0,0,0,0,0,0,0,5,0,0,5,5
2022,Syrian Arab Rep.,SYR,Kazakhstan,KAZ,0,0,5,0,0,0,5,0,0,0,13,0,0,13,18
2022,Ukraine,UKR,Kazakhstan,KAZ,0,0,61,205,100,0,366,0,0,54,102,28,0,184,550
2022,Uzbekistan,UZB,Kazakhstan,KAZ,0,0,0,10,0,0,10,0,0,0,0,0,0,0,10
2022,Afghanistan,AFG,Kenya,KEN,0,0,0,24,0,0,24,8,0,6,20,0,0,34,58
2022,Egypt,EGY,Kenya,KEN,0,5,6,0,0,0,11,0,0,0,12,0,0,12,23
2022,Burundi,BDI,Kenya,KEN,2245,2101,1286,4759,128,0,10519,2268,2227,1250,8224,103,0,14072,24591
2022,Central African Rep.,CAF,Kenya,KEN,0,0,0,6,0,0,6,0,0,0,7,0,0,7,13
2022,Chad,TCD,Kenya,KEN,0,0,0,0,0,0,0,0,0,0,5,0,0,5,5
2022,Cameroon,CMR,Kenya,KEN,0,0,5,5,0,0,10,0,0,0,49,0,0,49,59
2022,Congo,COG,Kenya,KEN,17,0,5,27,0,0,49,5,11,5,51,0,0,72,121
2022,Dem. Rep. of the Congo,COD,Kenya,KEN,3352,4468,3546,13201,527,0,25094,3587,4678,3548,16664,409,0,28886,53980
2022,Eritrea,ERI,Kenya,KEN,51,117,105,1017,32,0,1322,64,134,122,901,56,0,1277,2599
2022,Ethiopia,ETH,Kenya,KEN,1624,2955,2057,8469,297,0,15402,1768,3110,2161,9960,336,0,17335,32737
2022,Cote d'Ivoire,CIV,Kenya,KEN,0,0,0,0,0,0,0,0,5,0,0,0,0,5,5
2022,India,IND,Kenya,KEN,0,0,0,6,0,0,6,0,0,0,0,0,0,0,6
2022,Sri Lanka,LKA,Kenya,KEN,0,0,0,0,0,0,0,0,0,0,9,0,0,9,9
2022,Mozambique,MOZ,Kenya,KEN,0,0,0,9,0,0,9,0,0,0,0,0,0,0,9
2022,Nigeria,NGA,Kenya,KEN,0,0,0,0,0,0,0,0,0,0,15,0,0,15,15
2022,Pakistan,PAK,Kenya,KEN,0,0,0,5,0,0,5,0,6,0,5,5,0,16,21
2022,Rwanda,RWA,Kenya,KEN,90,175,133,653,36,0,1087,88,169,146,742,72,0,1217,2304
2022,Somalia,SOM,Kenya,KEN,18088,32108,25134,67029,5894,0,148253,18967,33484,26511,56056,5377,0,140395,288648
2022,South Sudan,SSD,Kenya,KEN,9219,16779,13636,30079,1535,0,71248,9843,18987,19725,33056,524,0,82135,153383
2022,Sudan,SDN,Kenya,KEN,338,564,695,2088,34,0,3719,353,708,1157,4473,30,0,6721,10440
2022,Syrian Arab Rep.,SYR,Kenya,KEN,0,0,0,0,0,0,0,0,0,0,10,0,0,10,10
2022,United Rep. of Tanzania,TZA,Kenya,KEN,11,0,6,43,0,0,60,0,7,10,61,0,0,78,138
2022,Türkiye,TUR,Kenya,KEN,0,27,10,55,0,0,92,7,24,17,67,0,0,115,207
2022,Uganda,UGA,Kenya,KEN,211,299,257,845,17,0,1629,227,279,231,1340,53,0,2130,3759
2022,Yemen,YEM,Kenya,KEN,0,29,9,66,10,0,114,0,24,17,171,5,0,217,331
2022,Zimbabwe,ZWE,Kenya,KEN,0,0,6,0,0,0,6,0,7,0,0,0,0,7,13
2022,Afghanistan,AFG,Kyrgyzstan,KGZ,24,36,24,118,11,0,213,20,42,33,193,12,0,300,513
2022,Palestinian,PSE,Kyrgyzstan,KGZ,0,0,0,5,0,0,5,0,0,0,0,0,0,0,5
2022,Iraq,IRQ,Kyrgyzstan,KGZ,0,0,0,0,0,0,0,0,0,0,5,0,0,5,5
2022,Pakistan,PAK,Kyrgyzstan,KGZ,0,5,0,0,0,0,5,0,0,0,0,0,0,0,5
2022,Philippines,PHL,Kyrgyzstan,KGZ,0,5,0,0,0,0,5,0,0,0,0,0,0,0,5
2022,Syrian Arab Rep.,SYR,Kyrgyzstan,KGZ,0,5,0,15,0,0,20,0,0,8,44,0,0,52,72
2022,Tajikistan,TJK,Kyrgyzstan,KGZ,0,6,0,8,0,0,14,0,6,0,7,0,0,13,27
2022,Turkmenistan,TKM,Kyrgyzstan,KGZ,0,0,0,5,0,0,5,0,0,0,6,0,0,6,11
2022,Türkiye,TUR,Kyrgyzstan,KGZ,6,18,17,60,6,0,107,5,27,19,101,12,0,164,271
2022,Ukraine,UKR,Kyrgyzstan,KGZ,0,0,0,6,5,0,11,0,0,0,13,0,0,13,24
2022,Venezuela (Bolivarian Republic of),VEN,Kyrgyzstan,KGZ,0,5,0,0,0,0,5,0,0,0,0,0,0,0,5
2022,Afghanistan,AFG,Rep. of Korea,KOR,0,0,0,0,0,0,0,0,0,0,0,0,0,0,140
2022,Algeria,DZA,Rep. of Korea,KOR,0,0,0,0,0,0,0,0,0,0,0,0,0,0,109
2022,Angola,AGO,Rep. of Korea,KOR,0,0,0,0,0,0,0,0,0,0,0,0,0,0,7
2022,Egypt,EGY,Rep. of Korea,KOR,0,0,0,0,0,0,0,0,0,0,0,0,0,0,825
2022,Burundi,BDI,Rep. of Korea,KOR,0,0,0,0,0,0,0,0,0,0,0,0,0,0,89
2022,Bangladesh,BGD,Rep. of Korea,KOR,0,0,0,0,0,0,0,0,0,0,0,0,0,0,1071
2022,Cambodia,KHM,Rep. of Korea,KOR,0,0,0,0,0,0,0,0,0,0,0,0,0,0,20
2022,China,CHN,Rep. of Korea,KOR,0,0,0,0,0,0,0,0,0,0,0,0,0,0,1215
2022,Cameroon,CMR,Rep. of Korea,KOR,0,0,0,0,0,0,0,0,0,0,0,0,0,0,186
2022,Dem. Rep. of the Congo,COD,Rep. of Korea,KOR,0,0,0,0,0,0,0,0,0,0,0,0,0,0,101
2022,Eritrea,ERI,Rep. of Korea,KOR,0,0,0,0,0,0,0,0,0,0,0,0,0,0,10
2022,Ethiopia,ETH,Rep. of Korea,KOR,0,0,0,0,0,0,0,0,0,0,0,0,0,0,411
2022,Gambia,GMB,Rep. of Korea,KOR,0,0,0,0,0,0,0,0,0,0,0,0,0,0,48
2022,Ghana,GHA,Rep. of Korea,KOR,0,0,0,0,0,0,0,0,0,0,0,0,0,0,204
2022,Guinea,GIN,Rep. of Korea,KOR,0,0,0,0,0,0,0,0,0,0,0,0,0,0,81
2022,Haiti,HTI,Rep. of Korea,KOR,0,0,0,0,0,0,0,0,0,0,0,0,0,0,179
2022,Cote d'Ivoire,CIV,Rep. of Korea,KOR,0,0,0,0,0,0,0,0,0,0,0,0,0,0,53
2022,India,IND,Rep. of Korea,KOR,0,0,0,0,0,0,0,0,0,0,0,0,0,0,2077
2022,Iran (Islamic Rep. of),IRN,Rep. of Korea,KOR,0,0,0,0,0,0,0,0,0,0,0,0,0,0,75
2022,Iraq,IRQ,Rep. of Korea,KOR,0,0,0,0,0,0,0,0,0,0,0,0,0,0,142
2022,Jordan,JOR,Rep. of Korea,KOR,0,0,0,0,0,0,0,0,0,0,0,0,0,0,18
2022,Kazakhstan,KAZ,Rep. of Korea,KOR,0,0,0,0,0,0,0,0,0,0,0,0,0,0,2196
2022,Kenya,KEN,Rep. of Korea,KOR,0,0,0,0,0,0,0,0,0,0,0,0,0,0,42
2022,Kyrgyzstan,KGZ,Rep. of Korea,KOR,0,0,0,0,0,0,0,0,0,0,0,0,0,0,233
2022,Liberia,LBR,Rep. of Korea,KOR,0,0,0,0,0,0,0,0,0,0,0,0,0,0,170
2022,Libya,LBY,Rep. of Korea,KOR,0,0,0,0,0,0,0,0,0,0,0,0,0,0,94
2022,Sri Lanka,LKA,Rep. of Korea,KOR,0,0,0,0,0,0,0,0,0,0,0,0,0,0,217
2022,Mali,MLI,Rep. of Korea,KOR,0,0,0,0,0,0,0,0,0,0,0,0,0,0,131
2022,Malaysia,MYS,Rep. of Korea,KOR,0,0,0,0,0,0,0,0,0,0,0,0,0,0,356
2022,Mongolia,MNG,Rep. of Korea,KOR,0,0,0,0,0,0,0,0,0,0,0,0,0,0,243
2022,Morocco,MAR,Rep. of Korea,KOR,0,0,0,0,0,0,0,0,0,0,0,0,0,0,325
2022,Myanmar,MMR,Rep. of Korea,KOR,0,0,0,0,0,0,0,0,0,0,0,0,0,0,862
2022,Nepal,NPL,Rep. of Korea,KOR,0,0,0,0,0,0,0,0,0,0,0,0,0,0,339
2022,Nigeria,NGA,Rep. of Korea,KOR,0,0,0,0,0,0,0,0,0,0,0,0,0,0,406
2022,Pakistan,PAK,Rep. of Korea,KOR,0,0,0,0,0,0,0,0,0,0,0,0,0,0,978
2022,Philippines,PHL,Rep. of Korea,KOR,0,0,0,0,0,0,0,0,0,0,0,0,0,0,157
2022,South Africa,ZAF,Rep. of Korea,KOR,0,0,0,0,0,0,0,0,0,0,0,0,0,0,77
2022,Russian Federation,RUS,Rep. of Korea,KOR,0,0,0,0,0,0,0,0,0,0,0,0,0,0,1217
2022,Rwanda,RWA,Rep. of Korea,KOR,0,0,0,0,0,0,0,0,0,0,0,0,0,0,81
2022,Senegal,SEN,Rep. of Korea,KOR,0,0,0,0,0,0,0,0,0,0,0,0,0,0,17
2022,Viet Nam,VNM,Rep. of Korea,KOR,0,0,0,0,0,0,0,0,0,0,0,0,0,0,14
2022,Stateless,XXA,Rep. of Korea,KOR,0,0,0,0,0,0,0,0,0,0,0,0,0,0,10
2022,Sudan,SDN,Rep. of Korea,KOR,0,0,0,0,0,0,0,0,0,0,0,0,0,0,80
2022,Syrian Arab Rep.,SYR,Rep. of Korea,KOR,0,0,0,0,0,0,0,0,0,0,0,0,0,0,1320
2022,United Rep. of Tanzania,TZA,Rep. of Korea,KOR,0,0,0,0,0,0,0,0,0,0,0,0,0,0,115
2022,Thailand,THA,Rep. of Korea,KOR,0,0,0,0,0,0,0,0,0,0,0,0,0,0,93
2022,Tajikistan,TJK,Rep. of Korea,KOR,0,0,0,0,0,0,0,0,0,0,0,0,0,0,61
2022,Tunisia,TUN,Rep. of Korea,KOR,0,0,0,0,0,0,0,0,0,0,0,0,0,0,111
2022,Türkiye,TUR,Rep. of Korea,KOR,0,0,0,0,0,0,0,0,0,0,0,0,0,0,1118
2022,Uganda,UGA,Rep. of Korea,KOR,0,0,0,0,0,0,0,0,0,0,0,0,0,0,113
2022,Unknown ,UNK,Rep. of Korea,KOR,0,0,0,0,0,0,0,0,0,0,0,0,0,0,375
2022,Ukraine,UKR,Rep. of Korea,KOR,0,0,0,0,0,0,0,0,0,0,0,0,0,0,39
2022,Uzbekistan,UZB,Rep. of Korea,KOR,0,0,0,0,0,0,0,0,0,0,0,0,0,0,235
2022,Yemen,YEM,Rep. of Korea,KOR,0,0,0,0,0,0,0,0,0,0,0,0,0,0,891
2022,Afghanistan,AFG,Kuwait,KWT,0,0,5,6,0,0,11,0,0,6,0,0,0,6,17
2022,Egypt,EGY,Kuwait,KWT,0,0,0,6,0,0,6,0,0,0,15,0,0,15,21
2022,Djibouti,DJI,Kuwait,KWT,0,0,0,0,5,0,5,0,0,0,0,0,0,0,5
2022,Eritrea,ERI,Kuwait,KWT,0,0,0,11,0,0,11,0,0,5,16,0,0,21,32
2022,Ethiopia,ETH,Kuwait,KWT,0,0,0,6,0,0,6,0,0,0,0,0,0,0,6
2022,Palestinian,PSE,Kuwait,KWT,0,5,0,0,0,0,5,0,0,0,5,0,0,5,10
2022,Iran (Islamic Rep. of),IRN,Kuwait,KWT,0,0,5,21,0,0,26,0,0,0,34,5,0,39,65
2022,Iraq,IRQ,Kuwait,KWT,8,18,36,190,25,0,277,0,28,41,204,26,0,299,576
2022,Jordan,JOR,Kuwait,KWT,0,0,0,6,0,0,6,0,0,0,0,0,0,0,6
2022,Sri Lanka,LKA,Kuwait,KWT,0,0,0,6,0,0,6,0,0,0,0,0,0,0,6
2022,Philippines,PHL,Kuwait,KWT,0,0,0,5,0,0,5,0,0,0,0,0,0,0,5
2022,Somalia,SOM,Kuwait,KWT,0,27,30,230,40,0,327,5,21,41,187,31,0,285,612
2022,Sudan,SDN,Kuwait,KWT,0,0,0,5,0,0,5,0,5,0,6,0,0,11,16
2022,Syrian Arab Rep.,SYR,Kuwait,KWT,5,24,18,66,10,0,123,10,19,20,70,11,0,130,253
2022,Yemen,YEM,Kuwait,KWT,0,0,0,5,0,0,5,0,9,0,0,0,0,9,14
2022,Central African Rep.,CAF,Liberia,LBR,0,0,0,5,0,0,5,0,0,0,0,0,0,0,5
2022,Cameroon,CMR,Liberia,LBR,0,0,0,0,0,0,0,0,0,0,6,0,0,6,6
2022,Dem. Rep. of the Congo,COD,Liberia,LBR,0,6,5,14,0,0,25,0,0,8,0,0,0,8,33
2022,Guinea,GIN,Liberia,LBR,0,0,0,0,0,0,0,0,0,0,5,0,0,5,5
2022,Cote d'Ivoire,CIV,Liberia,LBR,62,133,86,302,19,0,602,50,96,82,382,17,0,627,1229
2022,Mali,MLI,Liberia,LBR,0,0,0,9,0,0,9,0,5,0,5,0,0,10,19
2022,Nigeria,NGA,Liberia,LBR,0,5,0,0,0,0,5,0,0,0,5,0,0,5,10
2022,Pakistan,PAK,Liberia,LBR,0,0,0,0,0,0,0,0,7,0,0,0,0,7,7
2022,Rwanda,RWA,Liberia,LBR,0,0,0,0,0,0,0,5,0,0,0,0,0,5,5
2022,Somalia,SOM,Liberia,LBR,0,0,0,0,0,0,0,0,0,0,5,0,0,5,5
2022,South Sudan,SSD,Liberia,LBR,0,0,0,0,0,0,0,0,0,5,0,0,0,5,5
2022,Sudan,SDN,Liberia,LBR,0,5,0,0,0,0,5,0,0,0,6,0,0,6,11
2022,Syrian Arab Rep.,SYR,Liberia,LBR,0,0,0,14,0,0,14,0,8,0,58,0,0,66,80
2022,Togo,TGO,Liberia,LBR,0,0,0,0,0,0,0,0,0,0,5,0,0,5,5
2022,Türkiye,TUR,Liberia,LBR,0,0,0,7,0,0,7,0,0,0,9,0,0,9,16
2022,Afghanistan,AFG,Libya,LBY,5,0,0,0,0,0,5,0,0,0,0,0,0,0,5
2022,Cameroon,CMR,Libya,LBY,0,0,0,5,0,0,5,0,0,0,0,0,0,0,5
2022,Congo,COG,Libya,LBY,5,0,0,0,0,0,5,0,0,0,0,0,0,0,5
2022,Eritrea,ERI,Libya,LBY,91,71,94,847,5,0,1108,99,70,831,3665,0,0,4665,5773
2022,Ethiopia,ETH,Libya,LBY,75,14,29,377,0,0,495,80,18,210,991,0,0,1299,1794
2022,Palestinian,PSE,Libya,LBY,46,118,94,320,30,0,608,41,108,99,289,53,0,590,1198
2022,Iraq,IRQ,Libya,LBY,0,30,5,69,5,0,109,0,0,12,78,5,0,95,204
2022,Liberia,LBR,Libya,LBY,5,0,0,0,0,0,5,0,0,0,0,0,0,0,5
2022,Nigeria,NGA,Libya,LBY,0,0,0,0,0,0,0,0,7,14,0,0,0,21,21
2022,Somalia,SOM,Libya,LBY,26,0,48,162,0,0,236,29,5,181,463,0,0,678,914
2022,South Sudan,SSD,Libya,LBY,6,19,15,38,0,0,78,9,9,35,288,0,0,341,419
2022,Sudan,SDN,Libya,LBY,990,1112,642,3291,170,0,6205,1002,1177,1342,9709,392,0,13622,19827
2022,Syrian Arab Rep.,SYR,Libya,LBY,975,1575,875,3056,163,0,6644,1094,1595,1026,3924,179,0,7818,14462
2022,Türkiye,TUR,Libya,LBY,0,0,0,0,0,0,0,0,5,0,0,0,0,5,5
2022,Yemen,YEM,Libya,LBY,5,8,7,12,0,0,32,6,0,6,36,0,0,48,80
2022,Afghanistan,AFG,Lebanon,LBN,5,6,0,16,0,0,27,0,0,0,17,0,0,17,44
2022,Algeria,DZA,Lebanon,LBN,0,0,0,6,0,0,6,0,0,0,0,0,0,0,6
2022,Egypt,EGY,Lebanon,LBN,24,62,40,138,0,0,264,31,73,50,207,9,0,370,634
2022,Armenia,ARM,Lebanon,LBN,0,0,0,9,0,0,9,8,0,0,0,0,0,8,17
2022,Bahrain,BHR,Lebanon,LBN,0,0,5,0,0,0,5,0,0,0,13,0,0,13,18
2022,Bangladesh,BGD,Lebanon,LBN,9,12,5,65,0,0,91,5,6,0,44,0,0,55,146
2022,Cameroon,CMR,Lebanon,LBN,0,7,0,10,0,0,17,0,0,0,0,0,0,0,17
2022,Dem. Rep. of the Congo,COD,Lebanon,LBN,0,0,0,11,0,0,11,0,0,0,5,0,0,5,16
2022,Eritrea,ERI,Lebanon,LBN,0,0,0,28,5,0,33,0,0,0,0,0,0,0,33
2022,Ethiopia,ETH,Lebanon,LBN,63,32,0,1293,0,0,1388,84,15,0,56,0,0,155,1543
2022,Gambia,GMB,Lebanon,LBN,0,0,0,6,0,0,6,0,0,5,0,0,0,5,11
2022,Ghana,GHA,Lebanon,LBN,0,0,0,5,0,0,5,0,0,0,0,0,0,0,5
2022,Cote d'Ivoire,CIV,Lebanon,LBN,0,0,0,5,0,0,5,0,0,0,0,0,0,0,5
2022,India,IND,Lebanon,LBN,0,0,0,5,0,0,5,0,0,0,5,0,0,5,10
2022,Iran (Islamic Rep. of),IRN,Lebanon,LBN,0,0,0,37,0,0,37,0,8,10,34,0,0,52,89
2022,Iraq,IRQ,Lebanon,LBN,132,448,442,1678,295,0,2995,178,460,460,2250,321,0,3669,6664
2022,Jordan,JOR,Lebanon,LBN,0,14,11,47,5,0,77,5,6,0,43,0,0,54,131
2022,Kenya,KEN,Lebanon,LBN,0,0,0,13,0,0,13,5,0,0,0,0,0,5,18
2022,Kuwait,KWT,Lebanon,LBN,0,0,0,9,0,0,9,0,0,0,0,0,0,0,9
2022,Libya,LBY,Lebanon,LBN,0,6,5,5,0,0,16,0,0,0,11,0,0,11,27
2022,Sri Lanka,LKA,Lebanon,LBN,0,0,0,29,5,0,34,0,0,0,5,0,0,5,39
2022,Madagascar,MDG,Lebanon,LBN,0,0,0,12,0,0,12,5,0,0,0,0,0,5,17
2022,Rep. of Moldova,MDA,Lebanon,LBN,0,0,5,0,0,0,5,0,0,0,0,0,0,0,5
2022,Morocco,MAR,Lebanon,LBN,0,0,0,11,0,0,11,0,0,0,0,0,0,0,11
2022,Nigeria,NGA,Lebanon,LBN,5,7,0,17,0,0,29,8,5,0,24,0,0,37,66
2022,Pakistan,PAK,Lebanon,LBN,0,0,6,8,0,0,14,0,5,0,0,0,0,5,19
2022,Philippines,PHL,Lebanon,LBN,0,0,0,29,0,0,29,0,0,0,0,0,0,0,29
2022,Saudi Arabia,SAU,Lebanon,LBN,0,5,0,0,0,0,5,0,0,6,0,0,0,6,11
2022,Sierra Leone,SLE,Lebanon,LBN,0,0,0,5,0,0,5,0,0,0,0,0,0,0,5
2022,Somalia,SOM,Lebanon,LBN,0,0,5,5,0,0,10,0,0,0,5,0,0,5,15
2022,South Sudan,SSD,Lebanon,LBN,0,0,7,5,0,0,12,0,0,9,14,0,0,23,35
2022,Sudan,SDN,Lebanon,LBN,160,103,23,143,5,0,434,175,82,26,1494,41,0,1818,2252
2022,Syrian Arab Rep.,SYR,Lebanon,LBN,53426,96451,68457,192833,11536,0,422703,55646,100164,71514,155293,9395,0,392012,814715
2022,Togo,TGO,Lebanon,LBN,0,0,0,5,0,0,5,0,0,0,0,0,0,0,5
2022,Tunisia,TUN,Lebanon,LBN,0,0,0,0,0,0,0,0,0,0,9,0,0,9,9
2022,Türkiye,TUR,Lebanon,LBN,0,0,5,0,0,0,5,0,5,8,10,0,0,23,28
2022,Ukraine,UKR,Lebanon,LBN,0,0,0,11,0,0,11,0,0,5,0,0,0,5,16
2022,Yemen,YEM,Lebanon,LBN,0,16,6,37,0,0,59,6,10,0,61,0,0,77,136
2022,Cameroon,CMR,Lesotho,LSO,0,5,0,8,0,0,13,0,0,8,0,0,0,8,21
2022,Congo,COG,Lesotho,LSO,0,0,0,0,0,0,0,0,0,0,7,0,0,7,7
2022,Dem. Rep. of the Congo,COD,Lesotho,LSO,16,36,21,95,0,0,168,17,41,27,100,5,0,190,358
2022,Eritrea,ERI,Lesotho,LSO,0,8,0,9,0,0,17,5,0,5,59,0,0,69,86
2022,Ethiopia,ETH,Lesotho,LSO,0,0,0,0,0,0,0,0,0,0,17,0,0,17,17
2022,Nigeria,NGA,Lesotho,LSO,0,7,0,0,0,0,7,0,0,0,5,0,0,5,12
2022,Pakistan,PAK,Lesotho,LSO,0,0,0,0,0,0,0,0,0,0,5,0,0,5,5
2022,Somalia,SOM,Lesotho,LSO,0,0,0,0,0,0,0,0,0,0,5,0,0,5,5
2022,Uganda,UGA,Lesotho,LSO,0,0,0,9,0,0,9,0,0,0,5,0,0,5,14
2022,Zambia,ZMB,Lesotho,LSO,0,0,0,0,0,0,0,0,0,0,5,0,0,5,5
2022,Zimbabwe,ZWE,Lesotho,LSO,9,0,0,0,0,0,9,0,0,0,0,0,0,0,9
2022,China,CHN,Liechtenstein,LIE,0,0,0,0,0,0,0,0,0,0,0,0,0,0,33
2022,Eritrea,ERI,Liechtenstein,LIE,0,0,0,0,0,0,0,0,0,0,0,0,0,0,12
2022,Iran (Islamic Rep. of),IRN,Liechtenstein,LIE,0,0,0,0,0,0,0,0,0,0,0,0,0,0,11
2022,Iraq,IRQ,Liechtenstein,LIE,0,0,0,0,0,0,0,0,0,0,0,0,0,0,13
2022,Somalia,SOM,Liechtenstein,LIE,0,0,0,0,0,0,0,0,0,0,0,0,0,0,25
2022,Syrian Arab Rep.,SYR,Liechtenstein,LIE,0,0,0,0,0,0,0,0,0,0,0,0,0,0,34
2022,Ukraine,UKR,Liechtenstein,LIE,0,0,0,0,0,254,254,0,0,0,0,0,143,143,402
2022,Afghanistan,AFG,Sri Lanka,LKA,0,6,11,15,0,0,32,8,0,10,32,5,0,55,87
2022,Belarus,BLR,Sri Lanka,LKA,0,0,5,0,0,0,5,0,0,0,0,0,0,0,5
2022,Palestinian,PSE,Sri Lanka,LKA,0,0,0,0,0,0,0,0,0,0,5,0,0,5,5
2022,India,IND,Sri Lanka,LKA,5,0,0,0,0,0,5,0,0,0,0,0,0,0,5
2022,Iran (Islamic Rep. of),IRN,Sri Lanka,LKA,0,0,0,10,0,0,10,0,0,0,7,0,0,7,17
2022,Iraq,IRQ,Sri Lanka,LKA,0,0,0,0,0,0,0,0,0,0,5,0,0,5,5
2022,Myanmar,MMR,Sri Lanka,LKA,0,13,0,6,0,0,19,0,8,0,9,0,0,17,36
2022,Nigeria,NGA,Sri Lanka,LKA,0,0,0,0,0,0,0,0,0,0,5,0,0,5,5
2022,Pakistan,PAK,Sri Lanka,LKA,5,28,34,104,5,0,176,15,26,25,293,8,0,367,543
2022,Sudan,SDN,Sri Lanka,LKA,0,0,9,0,0,0,9,0,0,0,0,0,0,0,9
2022,Yemen,YEM,Sri Lanka,LKA,0,0,0,8,0,0,8,0,0,0,0,0,0,0,8
2022,Afghanistan,AFG,Lithuania,LTU,0,0,0,0,0,0,0,0,0,0,0,0,0,0,274
2022,Egypt,EGY,Lithuania,LTU,0,0,0,0,0,0,0,0,0,0,0,0,0,0,12
2022,Armenia,ARM,Lithuania,LTU,0,0,0,0,0,0,0,0,0,0,0,0,0,0,7
2022,Azerbaijan,AZE,Lithuania,LTU,0,0,0,0,0,0,0,0,0,0,0,0,0,0,37
2022,Belarus,BLR,Lithuania,LTU,0,0,0,0,0,0,0,0,0,0,0,0,0,0,584
2022,Cameroon,CMR,Lithuania,LTU,0,0,0,0,0,0,0,0,0,0,0,0,0,0,12
2022,Cuba,CUB,Lithuania,LTU,0,0,0,0,0,0,0,0,0,0,0,0,0,0,10
2022,Eritrea,ERI,Lithuania,LTU,0,0,0,0,0,0,0,0,0,0,0,0,0,0,46
2022,Ethiopia,ETH,Lithuania,LTU,0,0,0,0,0,0,0,0,0,0,0,0,0,0,5
2022,Georgia,GEO,Lithuania,LTU,0,0,0,0,0,0,0,0,0,0,0,0,0,0,18
2022,India,IND,Lithuania,LTU,0,0,0,0,0,0,0,0,0,0,0,0,0,0,5
2022,Iran (Islamic Rep. of),IRN,Lithuania,LTU,0,0,0,0,0,0,0,0,0,0,0,0,0,0,19
2022,Iraq,IRQ,Lithuania,LTU,0,0,0,0,0,0,0,0,0,0,0,0,0,0,104
2022,Kazakhstan,KAZ,Lithuania,LTU,0,0,0,0,0,0,0,0,0,0,0,0,0,0,12
2022,Kyrgyzstan,KGZ,Lithuania,LTU,0,0,0,0,0,0,0,0,0,0,0,0,0,0,5
2022,Sri Lanka,LKA,Lithuania,LTU,0,0,0,0,0,0,0,0,0,0,0,0,0,0,15
2022,Rep. of Moldova,MDA,Lithuania,LTU,0,0,0,0,0,0,0,0,0,0,0,0,0,0,20
2022,Nigeria,NGA,Lithuania,LTU,0,0,0,0,0,0,0,0,0,0,0,0,0,0,18
2022,Pakistan,PAK,Lithuania,LTU,0,0,0,0,0,0,0,0,0,0,0,0,0,0,5
2022,Russian Federation,RUS,Lithuania,LTU,0,0,0,0,0,0,0,0,0,0,0,0,0,0,948
2022,Somalia,SOM,Lithuania,LTU,0,0,0,0,0,0,0,0,0,0,0,0,0,0,27
2022,South Sudan,SSD,Lithuania,LTU,0,0,0,0,0,0,0,0,0,0,0,0,0,0,7
2022,Stateless,XXA,Lithuania,LTU,0,0,0,0,0,0,0,0,0,0,0,0,0,0,47
2022,Syrian Arab Rep.,SYR,Lithuania,LTU,0,0,0,0,0,0,0,0,0,0,0,0,0,0,493
2022,Tajikistan,TJK,Lithuania,LTU,0,0,0,0,0,0,0,0,0,0,0,0,0,0,110
2022,Türkiye,TUR,Lithuania,LTU,0,0,0,0,0,0,0,0,0,0,0,0,0,0,75
2022,Ukraine,UKR,Lithuania,LTU,0,0,0,0,0,44275,44275,0,0,0,0,0,20835,20835,65175
2022,United States of America,USA,Lithuania,LTU,0,0,0,0,0,0,0,0,0,0,0,0,0,0,5
2022,Uzbekistan,UZB,Lithuania,LTU,0,0,0,0,0,0,0,0,0,0,0,0,0,0,27
2022,Yemen,YEM,Lithuania,LTU,0,0,0,0,0,0,0,0,0,0,0,0,0,0,7
2022,Afghanistan,AFG,Luxembourg,LUX,0,0,0,0,0,61,61,0,0,0,0,0,179,179,771
2022,Albania,ALB,Luxembourg,LUX,0,0,0,0,0,5,5,0,0,0,0,0,20,20,72
2022,Algeria,DZA,Luxembourg,LUX,0,0,0,0,0,5,5,0,0,0,0,0,15,15,50
2022,Angola,AGO,Luxembourg,LUX,0,0,0,0,0,5,5,0,0,0,0,0,5,5,19
2022,Egypt,EGY,Luxembourg,LUX,0,0,0,0,0,0,0,0,0,0,0,0,5,5,13
2022,Armenia,ARM,Luxembourg,LUX,0,0,0,0,0,0,0,0,0,0,0,0,0,0,10
2022,Azerbaijan,AZE,Luxembourg,LUX,0,0,0,0,0,0,0,0,0,0,0,0,0,0,18
2022,Burundi,BDI,Luxembourg,LUX,0,0,0,0,0,5,5,0,0,0,0,0,15,15,25
2022,Bhutan,BTN,Luxembourg,LUX,0,0,0,0,0,0,0,0,0,0,0,0,0,0,5
2022,Burkina Faso,BFA,Luxembourg,LUX,0,0,0,0,0,0,0,0,0,0,0,0,0,0,6
2022,Belarus,BLR,Luxembourg,LUX,0,0,0,0,0,5,5,0,0,0,0,0,5,5,17
2022,Brazil,BRA,Luxembourg,LUX,0,0,0,0,0,0,0,0,0,0,0,0,0,0,6
2022,Bosnia and Herzegovina,BIH,Luxembourg,LUX,0,0,0,0,0,0,0,0,0,0,0,0,0,0,12
2022,China,CHN,Luxembourg,LUX,0,0,0,0,0,0,0,0,0,0,0,0,0,0,7
2022,Cameroon,CMR,Luxembourg,LUX,0,0,0,0,0,12,12,0,0,0,0,0,23,23,74
2022,Dem. Rep. of the Congo,COD,Luxembourg,LUX,0,0,0,0,0,10,10,0,0,0,0,0,10,10,67
2022,Colombia,COL,Luxembourg,LUX,0,0,0,0,0,18,18,0,0,0,0,0,17,17,35
2022,Cabo Verde,CPV,Luxembourg,LUX,0,0,0,0,0,0,0,0,0,0,0,0,0,0,5
2022,Eritrea,ERI,Luxembourg,LUX,0,0,0,0,0,110,110,0,0,0,0,0,230,230,2034
2022,Ethiopia,ETH,Luxembourg,LUX,0,0,0,0,0,11,11,0,0,0,0,0,34,34,115
2022,Gabon,GAB,Luxembourg,LUX,0,0,0,0,0,0,0,0,0,0,0,0,0,0,5
2022,Gambia,GMB,Luxembourg,LUX,0,0,0,0,0,0,0,0,0,0,0,0,5,5,13
2022,Georgia,GEO,Luxembourg,LUX,0,0,0,0,0,0,0,0,0,0,0,0,10,10,15
2022,Guinea-Bissau,GNB,Luxembourg,LUX,0,0,0,0,0,0,0,0,0,0,0,0,0,0,5
2022,Guinea,GIN,Luxembourg,LUX,0,0,0,0,0,5,5,0,0,0,0,0,15,15,57
2022,Cote d'Ivoire,CIV,Luxembourg,LUX,0,0,0,0,0,10,10,0,0,0,0,0,5,5,32
2022,India,IND,Luxembourg,LUX,0,0,0,0,0,0,0,0,0,0,0,0,0,0,10
2022,Iran (Islamic Rep. of),IRN,Luxembourg,LUX,0,0,0,0,0,40,40,0,0,0,0,0,55,55,350
2022,Iraq,IRQ,Luxembourg,LUX,0,0,0,0,0,15,15,0,0,0,0,0,65,65,917
2022,Kyrgyzstan,KGZ,Luxembourg,LUX,0,0,0,0,0,0,0,0,0,0,0,0,0,0,5
2022,Dem. People's Rep. of Korea,PRK,Luxembourg,LUX,0,0,0,0,0,0,0,0,0,0,0,0,0,0,11
2022,Kuwait,KWT,Luxembourg,LUX,0,0,0,0,0,0,0,0,0,0,0,0,10,10,16
2022,Liberia,LBR,Luxembourg,LUX,0,0,0,0,0,0,0,0,0,0,0,0,0,0,5
2022,Libya,LBY,Luxembourg,LUX,0,0,0,0,0,10,10,0,0,0,0,0,15,15,34
2022,Lebanon,LBN,Luxembourg,LUX,0,0,0,0,0,5,5,0,0,0,0,0,5,5,18
2022,Sri Lanka,LKA,Luxembourg,LUX,0,0,0,0,0,0,0,0,0,0,0,0,0,0,5
2022,Mauritania,MRT,Luxembourg,LUX,0,0,0,0,0,0,0,0,0,0,0,0,5,5,5
2022,North Macedonia,MKD,Luxembourg,LUX,0,0,0,0,0,0,0,0,0,0,0,0,5,5,5
2022,Mexico,MEX,Luxembourg,LUX,0,0,0,0,0,0,0,0,0,0,0,0,0,0,5
2022,Mali,MLI,Luxembourg,LUX,0,0,0,0,0,0,0,0,0,0,0,0,5,5,10
2022,Montenegro,MNE,Luxembourg,LUX,0,0,0,0,0,0,0,0,0,0,0,0,0,0,6
2022,Morocco,MAR,Luxembourg,LUX,0,0,0,0,0,0,0,0,0,0,0,0,25,25,33
2022,Myanmar,MMR,Luxembourg,LUX,0,0,0,0,0,0,0,0,0,0,0,0,0,0,5
2022,Niger,NER,Luxembourg,LUX,0,0,0,0,0,0,0,0,0,0,0,0,5,5,5
2022,Nigeria,NGA,Luxembourg,LUX,0,0,0,0,0,0,0,0,0,0,0,0,5,5,21
2022,Pakistan,PAK,Luxembourg,LUX,0,0,0,0,0,5,5,0,0,0,0,0,5,5,10
2022,Peru,PER,Luxembourg,LUX,0,0,0,0,0,0,0,0,0,0,0,0,5,5,5
2022,Russian Federation,RUS,Luxembourg,LUX,0,0,0,0,0,5,5,0,0,0,0,0,15,15,59
2022,Rwanda,RWA,Luxembourg,LUX,0,0,0,0,0,0,0,0,0,0,0,0,0,0,15
2022,El Salvador,SLV,Luxembourg,LUX,0,0,0,0,0,10,10,0,0,0,0,0,0,0,10
2022,Senegal,SEN,Luxembourg,LUX,0,0,0,0,0,0,0,0,0,0,0,0,5,5,19
2022,Somalia,SOM,Luxembourg,LUX,0,0,0,0,0,13,13,0,0,0,0,0,22,22,104
2022,Serbia and Kosovo: S/RES/1244 (1999),SRB,Luxembourg,LUX,0,0,0,0,0,10,10,0,0,0,0,0,5,5,160
2022,South Sudan,SSD,Luxembourg,LUX,0,0,0,0,0,0,0,0,0,0,0,0,5,5,5
2022,Stateless,XXA,Luxembourg,LUX,0,0,0,0,0,0,0,0,0,0,0,0,0,0,116
2022,Sudan,SDN,Luxembourg,LUX,0,0,0,0,0,5,5,0,0,0,0,0,20,20,103
2022,Syrian Arab Rep.,SYR,Luxembourg,LUX,0,0,0,0,0,261,261,0,0,0,0,0,679,679,3852
2022,United Rep. of Tanzania,TZA,Luxembourg,LUX,0,0,0,0,0,0,0,0,0,0,0,0,5,5,5
2022,Tajikistan,TJK,Luxembourg,LUX,0,0,0,0,0,0,0,0,0,0,0,0,5,5,5
2022,Turkmenistan,TKM,Luxembourg,LUX,0,0,0,0,0,0,0,0,0,0,0,0,0,0,5
2022,Togo,TGO,Luxembourg,LUX,0,0,0,0,0,0,0,0,0,0,0,0,5,5,13
2022,Tunisia,TUN,Luxembourg,LUX,0,0,0,0,0,5,5,0,0,0,0,0,20,20,36
2022,Türkiye,TUR,Luxembourg,LUX,0,0,0,0,0,31,31,0,0,0,0,0,79,79,264
2022,Uganda,UGA,Luxembourg,LUX,0,0,0,0,0,0,0,0,0,0,0,0,0,0,10
2022,Unknown ,UNK,Luxembourg,LUX,0,0,0,0,0,5,5,0,0,0,0,0,35,35,57
2022,Ukraine,UKR,Luxembourg,LUX,0,0,0,0,0,3063,3063,0,0,0,0,0,1452,1452,4525
2022,Venezuela (Bolivarian Republic of),VEN,Luxembourg,LUX,0,0,0,0,0,82,82,0,0,0,0,0,98,98,188
2022,Yemen,YEM,Luxembourg,LUX,0,0,0,0,0,0,0,0,0,0,0,0,5,5,42
2022,Zimbabwe,ZWE,Luxembourg,LUX,0,0,0,0,0,5,5,0,0,0,0,0,0,0,5
2022,Afghanistan,AFG,Latvia,LVA,0,0,0,0,0,0,0,0,0,0,0,0,0,0,237
2022,Egypt,EGY,Latvia,LVA,0,0,0,0,0,0,0,0,0,0,0,0,0,0,9
2022,Armenia,ARM,Latvia,LVA,0,0,0,0,0,0,0,0,0,0,0,0,0,0,11
2022,Azerbaijan,AZE,Latvia,LVA,0,0,0,0,0,0,0,0,0,0,0,0,0,0,38
2022,Bangladesh,BGD,Latvia,LVA,0,0,0,0,0,0,0,0,0,0,0,0,0,0,5
2022,Belarus,BLR,Latvia,LVA,0,0,0,0,0,0,0,0,0,0,0,0,0,0,174
2022,China,CHN,Latvia,LVA,0,0,0,0,0,0,0,0,0,0,0,0,0,0,5
2022,Eritrea,ERI,Latvia,LVA,0,0,0,0,0,0,0,0,0,0,0,0,0,0,35
2022,Palestinian,PSE,Latvia,LVA,0,0,0,0,0,0,0,0,0,0,0,0,0,0,7
2022,Georgia,GEO,Latvia,LVA,0,0,0,0,0,0,0,0,0,0,0,0,0,0,17
2022,India,IND,Latvia,LVA,0,0,0,0,0,0,0,0,0,0,0,0,0,0,7
2022,Iran (Islamic Rep. of),IRN,Latvia,LVA,0,0,0,0,0,0,0,0,0,0,0,0,0,0,53
2022,Iraq,IRQ,Latvia,LVA,0,0,0,0,0,0,0,0,0,0,0,0,0,0,76
2022,Israel,ISR,Latvia,LVA,0,0,0,0,0,0,0,0,0,0,0,0,0,0,7
2022,Kazakhstan,KAZ,Latvia,LVA,0,0,0,0,0,0,0,0,0,0,0,0,0,0,7
2022,Kyrgyzstan,KGZ,Latvia,LVA,0,0,0,0,0,0,0,0,0,0,0,0,0,0,5
2022,Lebanon,LBN,Latvia,LVA,0,0,0,0,0,0,0,0,0,0,0,0,0,0,5
2022,Sri Lanka,LKA,Latvia,LVA,0,0,0,0,0,0,0,0,0,0,0,0,0,0,10
2022,Rep. of Moldova,MDA,Latvia,LVA,0,0,0,0,0,0,0,0,0,0,0,0,0,0,17
2022,Pakistan,PAK,Latvia,LVA,0,0,0,0,0,0,0,0,0,0,0,0,0,0,12
2022,Russian Federation,RUS,Latvia,LVA,0,0,0,0,0,0,0,0,0,0,0,0,0,0,328
2022,Somalia,SOM,Latvia,LVA,0,0,0,0,0,0,0,0,0,0,0,0,0,0,5
2022,Syrian Arab Rep.,SYR,Latvia,LVA,0,0,0,0,0,0,0,0,0,0,0,0,0,0,330
2022,Tajikistan,TJK,Latvia,LVA,0,0,0,0,0,0,0,0,0,0,0,0,0,0,14
2022,Türkiye,TUR,Latvia,LVA,0,0,0,0,0,0,0,0,0,0,0,0,0,0,34
2022,Unknown ,UNK,Latvia,LVA,0,0,0,0,0,0,0,0,0,0,0,0,0,0,13
2022,Ukraine,UKR,Latvia,LVA,0,0,0,0,0,24192,24192,0,0,0,0,0,13608,13608,37810
2022,United States of America,USA,Latvia,LVA,0,0,0,0,0,0,0,0,0,0,0,0,0,0,6
2022,Uzbekistan,UZB,Latvia,LVA,0,0,0,0,0,0,0,0,0,0,0,0,0,0,27
2022,Afghanistan,AFG,Madagascar,MDG,0,0,0,6,0,0,6,0,0,0,10,0,0,10,16
2022,Dem. Rep. of the Congo,COD,Madagascar,MDG,0,0,0,0,0,0,0,0,0,0,5,0,0,5,5
2022,Pakistan,PAK,Madagascar,MDG,0,0,18,55,13,0,86,5,5,15,67,10,0,102,188
2022,Syrian Arab Rep.,SYR,Madagascar,MDG,0,0,0,5,0,0,5,0,0,0,0,0,0,0,5
2022,Yemen,YEM,Madagascar,MDG,0,0,0,14,0,0,14,0,0,0,5,0,0,5,19
2022,Benin,BEN,Mauritania,MRT,0,0,0,5,0,0,5,0,0,0,5,0,0,5,10
2022,Burkina Faso,BFA,Mauritania,MRT,6,12,0,19,0,0,37,6,7,0,83,0,0,96,133
2022,Central African Rep.,CAF,Mauritania,MRT,35,91,75,215,11,0,427,36,67,54,191,5,0,353,780
2022,Chad,TCD,Mauritania,MRT,0,0,0,7,0,0,7,0,0,0,8,0,0,8,15
2022,China,CHN,Mauritania,MRT,0,0,0,0,0,0,0,0,0,0,5,0,0,5,5
2022,Cameroon,CMR,Mauritania,MRT,5,6,0,57,0,0,68,7,0,5,106,0,0,118,186
2022,Congo,COG,Mauritania,MRT,0,0,0,8,0,0,8,0,0,6,16,0,0,22,30
2022,Dem. Rep. of the Congo,COD,Mauritania,MRT,0,7,14,11,0,0,32,0,7,0,23,0,0,30,62
2022,Ethiopia,ETH,Mauritania,MRT,0,0,0,8,0,0,8,0,0,0,8,0,0,8,16
2022,Gambia,GMB,Mauritania,MRT,0,0,0,0,0,0,0,0,0,0,9,0,0,9,9
2022,Palestinian,PSE,Mauritania,MRT,0,7,14,27,0,0,48,5,12,0,45,5,0,67,115
2022,Ghana,GHA,Mauritania,MRT,0,0,0,0,0,0,0,0,0,0,14,0,0,14,14
2022,Guinea,GIN,Mauritania,MRT,19,11,10,57,0,0,97,10,20,7,138,5,0,180,277
2022,Cote d'Ivoire,CIV,Mauritania,MRT,5,28,18,92,0,0,143,13,14,12,152,0,0,191,334
2022,Iraq,IRQ,Mauritania,MRT,0,0,0,10,0,0,10,0,0,0,9,5,0,14,24
2022,Liberia,LBR,Mauritania,MRT,0,0,0,13,0,0,13,0,0,0,17,0,0,17,30
2022,Libya,LBY,Mauritania,MRT,0,0,8,0,0,0,8,0,0,0,5,0,0,5,13
2022,Lebanon,LBN,Mauritania,MRT,0,6,5,11,0,0,22,5,15,5,10,0,0,35,57
2022,Mali,MLI,Mauritania,MRT,9674,12300,7467,21657,1848,0,52946,9432,11697,6956,19694,1783,0,49562,102508
2022,Niger,NER,Mauritania,MRT,9,0,0,10,0,0,19,7,8,0,25,0,0,40,59
2022,Nigeria,NGA,Mauritania,MRT,0,5,7,41,0,0,53,0,12,0,104,0,0,116,169
2022,Russian Federation,RUS,Mauritania,MRT,5,0,0,0,0,0,5,0,6,0,0,0,0,6,11
2022,Rwanda,RWA,Mauritania,MRT,0,0,0,5,0,0,5,0,0,0,0,0,0,0,5
2022,Senegal,SEN,Mauritania,MRT,5,5,0,88,0,0,98,6,5,5,269,0,0,285,383
2022,Sierra Leone,SLE,Mauritania,MRT,8,0,0,39,0,0,47,0,8,0,144,0,0,152,199
2022,Somalia,SOM,Mauritania,MRT,0,0,0,0,0,0,0,5,0,0,5,0,0,10,10
2022,Sudan,SDN,Mauritania,MRT,0,0,5,0,0,0,5,0,0,0,45,0,0,45,50
2022,Syrian Arab Rep.,SYR,Mauritania,MRT,21,51,34,145,14,0,265,28,53,31,190,11,0,313,578
2022,Togo,TGO,Mauritania,MRT,15,9,0,41,0,0,65,13,16,0,94,0,0,123,188
2022,Tunisia,TUN,Mauritania,MRT,0,0,0,5,0,0,5,0,0,0,0,0,0,0,5
2022,Türkiye,TUR,Mauritania,MRT,0,8,0,6,0,0,14,0,0,0,7,0,0,7,21
2022,Yemen,YEM,Mauritania,MRT,5,5,0,14,0,0,24,9,12,0,29,0,0,50,74
2022,Congo,COG,North Macedonia,MKD,5,0,0,0,0,0,5,0,0,0,0,0,0,0,5
2022,Cuba,CUB,North Macedonia,MKD,0,0,0,5,0,0,5,0,0,0,0,0,0,0,5
2022,Morocco,MAR,North Macedonia,MKD,0,0,0,0,0,0,0,0,0,0,8,0,0,8,8
2022,Serbia and Kosovo: S/RES/1244 (1999),SRB,North Macedonia,MKD,0,10,14,82,11,0,117,5,15,18,77,12,0,127,244
2022,Syrian Arab Rep.,SYR,North Macedonia,MKD,0,0,0,0,0,0,0,0,6,0,0,0,0,6,6
2022,Ukraine,UKR,North Macedonia,MKD,0,0,0,0,0,0,0,0,0,0,0,0,0,0,386
2022,Iraq,IRQ,Monaco,MCO,0,0,0,0,0,0,0,0,0,0,0,0,0,0,5
2022,Viet Nam,VNM,Monaco,MCO,0,0,0,0,0,0,0,0,0,0,0,0,0,0,7
2022,Syrian Arab Rep.,SYR,Monaco,MCO,0,0,0,0,0,0,0,0,0,0,0,0,0,0,5
2022,Afghanistan,AFG,Rep. of Moldova,MDA,0,0,0,0,0,0,0,0,0,0,0,0,13,13,32
2022,Anguilla,AIA,Rep. of Moldova,MDA,0,0,0,0,0,5,5,0,0,0,0,0,0,0,5
2022,Algeria,DZA,Rep. of Moldova,MDA,0,0,0,0,0,0,0,0,0,0,0,0,5,5,5
2022,Egypt,EGY,Rep. of Moldova,MDA,0,0,0,0,0,0,0,0,0,0,0,0,8,8,13
2022,Armenia,ARM,Rep. of Moldova,MDA,0,0,0,0,0,45,45,0,0,0,0,0,84,84,152
2022,Australia,AUS,Rep. of Moldova,MDA,0,0,0,0,0,0,0,0,0,0,0,0,5,5,5
2022,Austria,AUT,Rep. of Moldova,MDA,0,0,0,0,0,5,5,0,0,0,0,0,8,8,13
2022,Azerbaijan,AZE,Rep. of Moldova,MDA,0,0,0,0,0,248,248,0,0,0,0,0,474,474,794
2022,Belgium,BEL,Rep. of Moldova,MDA,0,0,0,0,0,5,5,0,0,0,0,0,5,5,10
2022,Belarus,BLR,Rep. of Moldova,MDA,0,0,0,0,0,25,25,0,0,0,0,0,44,44,87
2022,Bulgaria,BGR,Rep. of Moldova,MDA,0,0,0,0,0,107,107,0,0,0,0,0,264,264,371
2022,Canada,CAN,Rep. of Moldova,MDA,0,0,0,0,0,0,0,0,0,0,0,0,8,8,8
2022,China,CHN,Rep. of Moldova,MDA,0,0,0,0,0,29,29,0,0,0,0,0,49,49,83
2022,Cameroon,CMR,Rep. of Moldova,MDA,0,0,0,0,0,0,0,0,0,0,0,0,0,0,5
2022,Cuba,CUB,Rep. of Moldova,MDA,0,0,0,0,0,5,5,0,0,0,0,0,9,9,22
2022,Czechia,CZE,Rep. of Moldova,MDA,0,0,0,0,0,0,0,0,0,0,0,0,5,5,5
2022,Ecuador,ECU,Rep. of Moldova,MDA,0,0,0,0,0,5,5,0,0,0,0,0,15,15,20
2022,Ethiopia,ETH,Rep. of Moldova,MDA,0,0,0,0,0,0,0,0,0,0,0,0,0,0,5
2022,France,FRA,Rep. of Moldova,MDA,0,0,0,0,0,5,5,0,0,0,0,0,20,20,30
2022,United Kingdom of Great Britain and Northern Ireland,GBR,Rep. of Moldova,MDA,0,0,0,0,0,7,7,0,0,0,0,0,21,21,28
2022,Georgia,GEO,Rep. of Moldova,MDA,0,0,0,0,0,41,41,0,0,0,0,0,125,125,180
2022,Germany,DEU,Rep. of Moldova,MDA,0,0,0,0,0,15,15,0,0,0,0,0,35,35,50
2022,Greece,GRC,Rep. of Moldova,MDA,0,0,0,0,0,5,5,0,0,0,0,0,10,10,15
2022,Hungary,HUN,Rep. of Moldova,MDA,0,0,0,0,0,0,0,0,0,0,0,0,7,7,7
2022,India,IND,Rep. of Moldova,MDA,0,0,0,0,0,5,5,0,0,0,0,0,36,36,46
2022,Ireland,IRL,Rep. of Moldova,MDA,0,0,0,0,0,0,0,0,0,0,0,0,8,8,8
2022,Iran (Islamic Rep. of),IRN,Rep. of Moldova,MDA,0,0,0,0,0,0,0,0,0,0,0,0,15,15,20
2022,Iraq,IRQ,Rep. of Moldova,MDA,0,0,0,0,0,0,0,0,0,0,0,0,6,6,21
2022,Israel,ISR,Rep. of Moldova,MDA,0,0,0,0,0,45,45,0,0,0,0,0,134,134,186
2022,Italy,ITA,Rep. of Moldova,MDA,0,0,0,0,0,18,18,0,0,0,0,0,17,17,35
2022,Jordan,JOR,Rep. of Moldova,MDA,0,0,0,0,0,0,0,0,0,0,0,0,5,5,5
2022,Kazakhstan,KAZ,Rep. of Moldova,MDA,0,0,0,0,0,17,17,0,0,0,0,0,18,18,35
2022,Kyrgyzstan,KGZ,Rep. of Moldova,MDA,0,0,0,0,0,6,6,0,0,0,0,0,12,12,35
2022,Libya,LBY,Rep. of Moldova,MDA,0,0,0,0,0,0,0,0,0,0,0,0,0,0,5
2022,Lebanon,LBN,Rep. of Moldova,MDA,0,0,0,0,0,0,0,0,0,0,0,0,12,12,17
2022,Lithuania,LTU,Rep. of Moldova,MDA,0,0,0,0,0,9,9,0,0,0,0,0,17,17,26
2022,Latvia,LVA,Rep. of Moldova,MDA,0,0,0,0,0,5,5,0,0,0,0,0,9,9,14
2022,Morocco,MAR,Rep. of Moldova,MDA,0,0,0,0,0,0,0,0,0,0,0,0,5,5,19
2022,Nepal,NPL,Rep. of Moldova,MDA,0,0,0,0,0,0,0,0,0,0,0,0,5,5,5
2022,Nigeria,NGA,Rep. of Moldova,MDA,0,0,0,0,0,5,5,0,0,0,0,0,14,14,24
2022,Pakistan,PAK,Rep. of Moldova,MDA,0,0,0,0,0,0,0,0,0,0,0,0,6,6,6
2022,Philippines,PHL,Rep. of Moldova,MDA,0,0,0,0,0,0,0,0,0,0,0,0,5,5,5
2022,Poland,POL,Rep. of Moldova,MDA,0,0,0,0,0,11,11,0,0,0,0,0,21,21,32
2022,Portugal,PRT,Rep. of Moldova,MDA,0,0,0,0,0,8,8,0,0,0,0,0,9,9,17
2022,Romania,ROU,Rep. of Moldova,MDA,0,0,0,0,0,869,869,0,0,0,0,0,1457,1457,2326
2022,Russian Federation,RUS,Rep. of Moldova,MDA,0,0,0,0,0,539,539,0,0,0,0,0,451,451,1133
2022,Spain,ESP,Rep. of Moldova,MDA,0,0,0,0,0,0,0,0,0,0,0,0,5,5,5
2022,Viet Nam,VNM,Rep. of Moldova,MDA,0,0,0,0,0,24,24,0,0,0,0,0,57,57,89
2022,Sudan,SDN,Rep. of Moldova,MDA,0,0,0,0,0,0,0,0,0,0,0,0,0,0,9
2022,Sweden,SWE,Rep. of Moldova,MDA,0,0,0,0,0,0,0,0,0,0,0,0,5,5,5
2022,Switzerland,CHE,Rep. of Moldova,MDA,0,0,0,0,0,0,0,0,0,0,0,0,8,8,8
2022,Syrian Arab Rep.,SYR,Rep. of Moldova,MDA,0,0,0,0,0,5,5,0,0,0,0,0,24,24,233
2022,Tajikistan,TJK,Rep. of Moldova,MDA,0,0,0,0,0,9,9,0,0,0,0,0,22,22,58
2022,Turkmenistan,TKM,Rep. of Moldova,MDA,0,0,0,0,0,9,9,0,0,0,0,0,22,22,41
2022,Türkiye,TUR,Rep. of Moldova,MDA,0,0,0,0,0,21,21,0,0,0,0,0,160,160,276
2022,Ukraine,UKR,Rep. of Moldova,MDA,0,0,0,0,0,59158,59158,0,0,0,0,0,39688,39688,102104
2022,United States of America,USA,Rep. of Moldova,MDA,0,0,0,0,0,33,33,0,0,0,0,0,60,60,93
2022,Uzbekistan,UZB,Rep. of Moldova,MDA,0,0,0,0,0,26,26,0,0,0,0,0,59,59,98
2022,Yemen,YEM,Rep. of Moldova,MDA,0,0,0,0,0,0,0,0,0,0,0,0,5,5,10
2022,Afghanistan,AFG,Mexico,MEX,14,14,6,72,0,0,106,15,15,19,389,0,0,438,544
2022,Albania,ALB,Mexico,MEX,0,0,0,8,0,0,8,0,0,0,0,0,0,0,8
2022,Algeria,DZA,Mexico,MEX,0,0,0,0,0,0,0,0,0,0,14,0,0,14,14
2022,Angola,AGO,Mexico,MEX,34,112,96,412,0,0,654,46,113,87,461,5,0,712,1366
2022,Egypt,EGY,Mexico,MEX,0,0,0,5,0,0,5,0,0,0,18,0,0,18,23
2022,Argentina,ARG,Mexico,MEX,30,6,5,67,0,0,108,28,6,6,91,0,0,131,239
2022,Benin,BEN,Mexico,MEX,0,0,0,8,0,0,8,0,0,0,28,0,0,28,36
2022,Bangladesh,BGD,Mexico,MEX,9,5,0,30,0,0,44,8,9,6,196,0,0,219,263
2022,Burkina Faso,BFA,Mexico,MEX,5,0,0,11,0,0,16,0,5,0,97,0,0,102,118
2022,Belarus,BLR,Mexico,MEX,0,0,0,6,0,0,6,0,0,0,5,0,0,5,11
2022,Bolivia (Plurinational State of),BOL,Mexico,MEX,0,5,0,29,0,0,34,8,0,0,13,0,0,21,55
2022,Brazil,BRA,Mexico,MEX,2345,359,11,97,0,0,2812,2469,367,5,71,0,0,2912,5724
2022,Belize,BLZ,Mexico,MEX,5,9,8,15,0,0,37,14,8,14,20,0,0,56,93
2022,Cambodia,KHM,Mexico,MEX,0,0,13,17,0,0,30,0,7,5,29,0,0,41,71
2022,Canada,CAN,Mexico,MEX,0,0,0,5,0,0,5,0,0,0,8,0,0,8,13
2022,Central African Rep.,CAF,Mexico,MEX,0,0,0,5,0,0,5,0,0,0,0,0,0,0,5
2022,Chad,TCD,Mexico,MEX,6,0,0,0,0,0,6,0,0,0,0,0,0,0,6
2022,China,CHN,Mexico,MEX,0,0,0,12,0,0,12,0,0,0,36,0,0,36,48
2022,Chile,CHL,Mexico,MEX,3448,119,0,24,0,0,3591,3335,94,5,35,0,0,3469,7060
2022,Cameroon,CMR,Mexico,MEX,0,7,0,204,0,0,211,0,0,5,389,0,0,394,605
2022,Congo,COG,Mexico,MEX,6,7,7,36,0,0,56,5,6,5,77,0,0,93,149
2022,Dem. Rep. of the Congo,COD,Mexico,MEX,27,40,48,197,0,0,312,29,50,68,297,0,0,444,756
2022,Colombia,COL,Mexico,MEX,138,128,100,1251,38,0,1655,169,127,93,1915,42,0,2346,4001
2022,Costa Rica,CRI,Mexico,MEX,51,21,8,24,0,0,104,50,20,7,40,0,0,117,221
2022,Cuba,CUB,Mexico,MEX,293,501,298,9188,253,0,10533,268,504,393,15189,202,0,16556,27089
2022,Cabo Verde,CPV,Mexico,MEX,0,5,0,0,0,0,5,0,0,0,0,0,0,0,5
2022,Dominica,DMA,Mexico,MEX,0,0,0,6,0,0,6,0,0,0,10,0,0,10,16
2022,Dominican Rep.,DOM,Mexico,MEX,5,13,17,410,5,0,450,7,5,12,1048,6,0,1078,1528
2022,Ecuador,ECU,Mexico,MEX,90,74,36,305,0,0,505,106,50,42,706,8,0,912,1417
2022,Equatorial Guinea,GNQ,Mexico,MEX,0,0,0,0,0,0,0,0,0,0,9,0,0,9,9
2022,Eritrea,ERI,Mexico,MEX,0,0,5,9,0,0,14,0,0,0,94,0,0,94,108
2022,Ethiopia,ETH,Mexico,MEX,0,0,0,8,0,0,8,0,0,0,40,0,0,40,48
2022,French Guiana,GUF,Mexico,MEX,55,12,0,0,0,0,67,57,7,0,0,0,0,64,131
2022,Finland,FIN,Mexico,MEX,5,0,0,0,0,0,5,0,0,5,0,0,0,5,10
2022,France,FRA,Mexico,MEX,6,0,0,0,0,0,6,0,5,0,5,0,0,10,16
2022,Gambia,GMB,Mexico,MEX,0,0,0,0,0,0,0,0,0,0,31,0,0,31,31
2022,Palestinian,PSE,Mexico,MEX,0,0,0,6,0,0,6,0,0,0,13,0,0,13,19
2022,United Kingdom of Great Britain and Northern Ireland,GBR,Mexico,MEX,0,0,0,5,0,0,5,0,0,0,0,0,0,0,5
2022,Georgia,GEO,Mexico,MEX,0,0,0,0,0,0,0,0,0,0,5,0,0,5,5
2022,Germany,DEU,Mexico,MEX,0,0,0,5,0,0,5,0,0,0,9,0,0,9,14
2022,Ghana,GHA,Mexico,MEX,17,16,14,128,0,0,175,14,15,21,424,0,0,474,649
2022,Guadeloupe,GLP,Mexico,MEX,5,0,0,0,0,0,5,0,0,0,0,0,0,0,5
2022,Guinea-Bissau,GNB,Mexico,MEX,0,0,0,5,0,0,5,0,0,0,15,0,0,15,20
2022,Guatemala,GTM,Mexico,MEX,563,821,571,3496,62,0,5513,523,801,623,4744,107,0,6798,12311
2022,Guinea,GIN,Mexico,MEX,8,8,0,40,0,0,56,5,5,24,213,0,0,247,303
2022,Guyana,GUY,Mexico,MEX,8,5,0,0,0,0,13,14,0,0,5,0,0,19,32
2022,Haiti,HTI,Mexico,MEX,370,1427,784,21857,31,0,24469,345,1360,739,31371,54,0,33869,58338
2022,Honduras,HND,Mexico,MEX,4406,6120,3656,25745,281,0,40208,4600,6687,4788,40924,493,0,57492,97700
2022,Hungary,HUN,Mexico,MEX,0,0,0,6,0,0,6,0,0,0,0,0,0,0,6
2022,Cote d'Ivoire,CIV,Mexico,MEX,5,0,0,9,0,0,14,0,0,0,32,0,0,32,46
2022,India,IND,Mexico,MEX,0,5,0,14,0,0,19,0,0,8,87,0,0,95,114
2022,Iran (Islamic Rep. of),IRN,Mexico,MEX,0,0,0,17,0,0,17,0,5,0,44,0,0,49,66
2022,Iraq,IRQ,Mexico,MEX,0,0,0,9,0,0,9,0,5,0,40,0,0,45,54
2022,Italy,ITA,Mexico,MEX,0,0,0,0,0,0,0,0,0,0,14,0,0,14,14
2022,Jamaica,JAM,Mexico,MEX,0,0,0,13,0,0,13,0,0,5,26,0,0,31,44
2022,Jordan,JOR,Mexico,MEX,0,0,0,0,0,0,0,0,0,0,5,0,0,5,5
2022,Kazakhstan,KAZ,Mexico,MEX,8,8,0,17,0,0,33,0,7,0,22,0,0,29,62
2022,Kenya,KEN,Mexico,MEX,0,0,0,0,0,0,0,0,0,0,5,0,0,5,5
2022,Kyrgyzstan,KGZ,Mexico,MEX,0,6,0,8,0,0,14,8,0,5,8,0,0,21,35
2022,Rep. of Korea,KOR,Mexico,MEX,0,0,0,0,0,0,0,0,0,0,5,0,0,5,5
2022,Liberia,LBR,Mexico,MEX,0,0,0,0,0,0,0,0,0,0,5,0,0,5,5
2022,Saint Lucia,LCA,Mexico,MEX,0,5,0,0,0,0,5,0,0,0,0,0,0,0,5
2022,Lebanon,LBN,Mexico,MEX,0,0,0,5,0,0,5,0,0,0,14,0,0,14,19
2022,Sri Lanka,LKA,Mexico,MEX,0,0,5,14,0,0,19,0,0,5,29,0,0,34,53
2022,Mauritania,MRT,Mexico,MEX,0,0,0,0,0,0,0,5,0,0,95,0,0,100,100
2022,Mali,MLI,Mexico,MEX,5,0,0,7,0,0,12,0,0,0,72,0,0,72,84
2022,Mongolia,MNG,Mexico,MEX,0,0,0,5,0,0,5,0,0,0,116,0,0,116,121
2022,Morocco,MAR,Mexico,MEX,0,0,0,0,0,0,0,0,0,0,24,0,0,24,24
2022,Mozambique,MOZ,Mexico,MEX,0,0,0,0,0,0,0,0,0,0,5,0,0,5,5
2022,Nepal,NPL,Mexico,MEX,0,0,0,6,0,0,6,0,0,0,24,0,0,24,30
2022,Niger,NER,Mexico,MEX,0,0,0,0,0,0,0,0,0,0,6,0,0,6,6
2022,Nicaragua,NIC,Mexico,MEX,312,502,282,3590,34,0,4720,324,481,367,6414,72,0,7658,12378
2022,Nigeria,NGA,Mexico,MEX,0,7,0,40,0,0,47,0,5,5,190,0,0,200,247
2022,Pakistan,PAK,Mexico,MEX,0,5,0,11,0,0,16,5,0,0,87,0,0,92,108
2022,Panama,PAN,Mexico,MEX,79,22,0,11,0,0,112,99,17,0,21,0,0,137,249
2022,Paraguay,PRY,Mexico,MEX,0,0,0,7,0,0,7,5,0,0,0,0,0,5,12
2022,Peru,PER,Mexico,MEX,56,12,8,110,6,0,192,57,13,7,166,11,0,254,446
2022,Philippines,PHL,Mexico,MEX,0,0,0,6,0,0,6,0,0,0,0,0,0,0,6
2022,Poland,POL,Mexico,MEX,0,0,0,0,0,0,0,0,0,0,9,0,0,9,9
2022,Portugal,PRT,Mexico,MEX,0,0,0,5,0,0,5,0,0,0,5,0,0,5,10
2022,Romania,ROU,Mexico,MEX,0,0,0,0,0,0,0,0,0,0,7,0,0,7,7
2022,South Africa,ZAF,Mexico,MEX,0,0,5,6,0,0,11,0,0,0,12,0,0,12,23
2022,Russian Federation,RUS,Mexico,MEX,5,8,15,105,6,0,139,8,11,7,140,0,0,166,305
2022,Rwanda,RWA,Mexico,MEX,5,0,0,0,0,0,5,0,0,0,0,0,0,0,5
2022,El Salvador,SLV,Mexico,MEX,922,1590,1086,8857,160,0,12615,931,1814,1207,12572,192,0,16716,29331
2022,Senegal,SEN,Mexico,MEX,6,0,0,47,0,0,53,5,0,0,1335,0,0,1340,1393
2022,Sierra Leone,SLE,Mexico,MEX,5,6,5,23,0,0,39,0,6,5,59,0,0,70,109
2022,Somalia,SOM,Mexico,MEX,0,0,0,10,0,0,10,0,0,0,97,0,0,97,107
2022,Spain,ESP,Mexico,MEX,0,0,5,6,0,0,11,0,0,0,16,0,0,16,27
2022,Sudan,SDN,Mexico,MEX,0,0,0,0,0,0,0,0,0,0,18,0,0,18,18
2022,Suriname,SUR,Mexico,MEX,5,0,0,0,0,0,5,7,0,0,0,0,0,7,12
2022,Syrian Arab Rep.,SYR,Mexico,MEX,0,0,0,17,0,0,17,0,5,0,58,0,0,63,80
2022,Tajikistan,TJK,Mexico,MEX,0,0,0,5,0,0,5,0,0,0,8,0,0,8,13
2022,Togo,TGO,Mexico,MEX,5,0,0,25,0,0,30,0,0,0,98,0,0,98,128
2022,Trinidad and Tobago,TTO,Mexico,MEX,5,0,0,0,0,0,5,5,0,0,0,0,0,5,10
2022,Türkiye,TUR,Mexico,MEX,0,0,6,0,0,0,6,0,0,0,18,0,0,18,24
2022,Uganda,UGA,Mexico,MEX,0,6,0,13,0,0,19,6,0,0,21,0,0,27,46
2022,Ukraine,UKR,Mexico,MEX,0,0,12,84,10,0,106,9,9,5,51,0,0,74,180
2022,Uruguay,URY,Mexico,MEX,26,0,0,9,0,0,35,34,0,0,7,0,0,41,76
2022,United States of America,USA,Mexico,MEX,17,26,23,33,0,0,99,17,15,20,35,0,0,87,186
2022,Uzbekistan,UZB,Mexico,MEX,5,5,5,16,0,0,31,0,9,0,31,0,0,40,71
2022,Venezuela (Bolivarian Republic of),VEN,Mexico,MEX,507,1590,988,13263,1006,0,17354,551,1583,1204,17085,555,0,20978,91359
2022,Yemen,YEM,Mexico,MEX,0,5,0,5,0,0,10,0,0,0,84,0,0,84,94
2022,Burundi,BDI,Mali,MLI,0,0,0,8,0,0,8,0,0,0,9,0,0,9,17
2022,Bangladesh,BGD,Mali,MLI,0,0,0,0,0,0,0,0,0,0,32,0,0,32,32
2022,Burkina Faso,BFA,Mali,MLI,1940,3136,1373,7263,628,0,14340,2064,3173,1325,4282,616,0,11460,25800
2022,Central African Rep.,CAF,Mali,MLI,44,139,131,484,42,0,840,50,115,130,350,9,0,654,1494
2022,Chad,TCD,Mali,MLI,0,6,0,0,0,0,6,0,0,0,0,0,0,0,6
2022,Cameroon,CMR,Mali,MLI,0,0,0,5,0,0,5,0,0,0,13,0,0,13,18
2022,Congo,COG,Mali,MLI,0,6,0,23,0,0,29,0,7,7,6,0,0,20,49
2022,Dem. Rep. of the Congo,COD,Mali,MLI,12,22,28,100,9,0,171,10,31,27,78,5,0,151,322
2022,Eritrea,ERI,Mali,MLI,0,0,0,5,0,0,5,0,0,0,0,0,0,0,5
2022,Guinea,GIN,Mali,MLI,0,0,0,0,0,0,0,0,0,0,13,0,0,13,13
2022,Mauritania,MRT,Mali,MLI,746,1746,1418,3184,250,0,7344,760,1845,1362,3226,415,0,7608,14952
2022,Niger,NER,Mali,MLI,1831,2756,1005,3850,272,0,9714,1879,2705,879,2758,294,0,8515,18229
2022,Nigeria,NGA,Mali,MLI,0,5,0,0,0,0,5,0,0,0,5,0,0,5,10
2022,Pakistan,PAK,Mali,MLI,0,0,6,0,0,0,6,0,0,0,5,0,0,5,11
2022,Rwanda,RWA,Mali,MLI,0,0,0,5,0,0,5,0,0,0,5,0,0,5,10
2022,Sudan,SDN,Mali,MLI,0,0,0,0,0,0,0,0,0,0,7,0,0,7,7
2022,Syrian Arab Rep.,SYR,Mali,MLI,0,13,14,112,5,0,144,8,17,14,293,0,0,332,476
2022,Turks and Caicos Islands,TCA,Mali,MLI,0,0,0,6,0,0,6,0,0,0,0,0,0,0,6
2022,Togo,TGO,Mali,MLI,0,0,8,7,0,0,15,0,5,0,11,0,0,16,31
2022,Türkiye,TUR,Mali,MLI,0,5,0,6,0,0,11,0,0,0,18,0,0,18,29
2022,Afghanistan,AFG,Malaysia,MYS,123,229,173,907,59,0,1491,146,237,206,1266,46,0,1901,3392
2022,Algeria,DZA,Malaysia,MYS,0,0,0,10,0,0,10,0,6,0,0,0,0,6,16
2022,Egypt,EGY,Malaysia,MYS,0,6,5,20,0,0,31,0,0,7,58,0,0,65,96
2022,Bangladesh,BGD,Malaysia,MYS,0,0,0,9,0,0,9,0,5,0,38,0,0,43,52
2022,Cambodia,KHM,Malaysia,MYS,0,0,5,71,0,0,76,0,0,0,10,0,0,10,86
2022,Central African Rep.,CAF,Malaysia,MYS,0,0,0,0,0,0,0,0,0,5,0,0,0,5,5
2022,China,CHN,Malaysia,MYS,0,0,0,22,5,0,27,0,5,0,22,0,0,27,54
2022,Cameroon,CMR,Malaysia,MYS,0,0,0,9,0,0,9,0,0,0,21,0,0,21,30
2022,Dem. Rep. of the Congo,COD,Malaysia,MYS,0,0,0,0,0,0,0,0,9,0,0,0,0,9,9
2022,Eritrea,ERI,Malaysia,MYS,0,0,7,10,0,0,17,0,8,0,7,0,0,15,32
2022,Ethiopia,ETH,Malaysia,MYS,0,0,0,16,0,0,16,0,6,0,0,0,0,6,22
2022,Palestinian,PSE,Malaysia,MYS,24,37,25,101,11,0,198,15,32,37,338,17,0,439,637
2022,United Kingdom of Great Britain and Northern Ireland,GBR,Malaysia,MYS,0,0,5,0,0,0,5,0,0,0,0,0,0,0,5
2022,Guinea,GIN,Malaysia,MYS,8,0,0,7,0,0,15,0,5,0,17,0,0,22,37
2022,Cote d'Ivoire,CIV,Malaysia,MYS,0,0,0,0,0,0,0,0,0,0,5,0,0,5,5
2022,India,IND,Malaysia,MYS,0,0,0,14,0,0,14,0,0,0,13,0,0,13,27
2022,Iran (Islamic Rep. of),IRN,Malaysia,MYS,5,11,10,134,5,0,165,0,6,20,188,14,0,228,393
2022,Iraq,IRQ,Malaysia,MYS,5,54,40,197,25,0,321,13,33,57,290,35,0,428,749
2022,Jordan,JOR,Malaysia,MYS,0,0,0,5,0,0,5,0,0,0,0,0,0,0,5
2022,Liberia,LBR,Malaysia,MYS,0,0,0,11,0,0,11,0,0,0,18,0,0,18,29
2022,Libya,LBY,Malaysia,MYS,0,0,0,12,0,0,12,0,0,5,13,0,0,18,30
2022,Lebanon,LBN,Malaysia,MYS,0,0,0,0,0,0,0,0,0,5,0,0,0,5,5
2022,Sri Lanka,LKA,Malaysia,MYS,20,65,49,395,38,0,567,29,61,47,767,36,0,940,1507
2022,Mali,MLI,Malaysia,MYS,0,5,0,0,0,0,5,0,0,0,0,0,0,0,5
2022,Myanmar,MMR,Malaysia,MYS,6986,9798,3398,29706,587,0,50475,7666,10205,3782,84850,1187,0,107690,158165
2022,Nepal,NPL,Malaysia,MYS,0,0,0,0,0,0,0,0,0,0,9,0,0,9,9
2022,Nigeria,NGA,Malaysia,MYS,0,8,0,11,0,0,19,6,0,0,17,0,0,23,42
2022,Pakistan,PAK,Malaysia,MYS,234,465,370,1818,92,0,2979,270,503,404,2617,103,0,3897,6876
2022,Philippines,PHL,Malaysia,MYS,0,0,0,16,0,0,16,0,0,0,0,0,0,0,16
2022,Russian Federation,RUS,Malaysia,MYS,0,0,0,0,0,0,0,0,0,0,5,0,0,5,5
2022,Sierra Leone,SLE,Malaysia,MYS,0,0,0,23,0,0,23,0,0,0,22,0,0,22,45
2022,Somalia,SOM,Malaysia,MYS,69,228,169,1205,73,0,1744,93,194,183,789,30,0,1289,3033
2022,South Sudan,SSD,Malaysia,MYS,0,0,0,13,0,0,13,5,0,5,38,0,0,48,61
2022,Sudan,SDN,Malaysia,MYS,10,21,9,42,5,0,87,8,16,11,146,10,0,191,278
2022,Syrian Arab Rep.,SYR,Malaysia,MYS,74,153,96,582,41,0,946,70,154,139,1439,60,0,1862,2808
2022,Thailand,THA,Malaysia,MYS,0,5,0,30,0,0,35,0,0,7,0,0,0,7,42
2022,Uganda,UGA,Malaysia,MYS,0,0,0,15,0,0,15,0,0,0,0,0,0,0,15
2022,United States of America,USA,Malaysia,MYS,0,0,0,0,0,0,0,0,0,5,0,0,0,5,5
2022,Uzbekistan,UZB,Malaysia,MYS,0,0,0,8,0,0,8,0,0,0,0,0,0,0,8
2022,Yemen,YEM,Malaysia,MYS,66,144,124,615,30,0,979,71,153,144,1964,35,0,2367,3346
2022,Zimbabwe,ZWE,Malaysia,MYS,0,5,0,0,0,0,5,0,0,0,0,0,0,0,5
2022,Burundi,BDI,Malawi,MWI,913,1000,717,2583,82,0,5295,889,1017,812,5116,76,0,7910,13205
2022,Dem. Rep. of the Congo,COD,Malawi,MWI,3067,3681,2420,6858,268,0,16294,3102,3707,2608,9172,123,0,18712,35006
2022,Eritrea,ERI,Malawi,MWI,0,0,0,0,0,0,0,0,0,0,7,0,0,7,7
2022,Ethiopia,ETH,Malawi,MWI,6,8,0,8,0,0,22,11,0,0,71,0,0,82,104
2022,Cote d'Ivoire,CIV,Malawi,MWI,0,0,0,0,0,0,0,0,5,0,0,0,0,5,5
2022,Mozambique,MOZ,Malawi,MWI,0,0,6,6,0,0,12,5,5,5,6,0,0,21,33
2022,Rwanda,RWA,Malawi,MWI,417,614,501,2091,125,0,3748,466,586,491,2364,152,0,4059,7807
2022,Somalia,SOM,Malawi,MWI,12,21,5,37,0,0,75,10,22,5,57,0,0,94,169
2022,South Sudan,SSD,Malawi,MWI,0,0,0,0,0,0,0,0,0,0,5,0,0,5,5
2022,United Rep. of Tanzania,TZA,Malawi,MWI,0,0,0,0,0,0,0,0,0,0,5,0,0,5,5
2022,Türkiye,TUR,Malawi,MWI,0,10,0,16,0,0,26,0,14,0,15,0,0,29,55
2022,Uganda,UGA,Malawi,MWI,0,0,0,5,0,0,5,0,0,0,11,0,0,11,16
2022,Zimbabwe,ZWE,Malawi,MWI,0,0,0,8,0,0,8,0,0,0,0,0,0,0,8
2022,Algeria,DZA,Montenegro,MNE,0,0,0,0,0,0,0,0,0,0,8,0,0,8,8
2022,Armenia,ARM,Montenegro,MNE,0,0,0,0,0,0,0,0,5,0,0,0,0,5,5
2022,Belarus,BLR,Montenegro,MNE,0,0,6,0,0,0,6,0,5,0,5,0,0,10,16
2022,Cuba,CUB,Montenegro,MNE,0,5,0,17,0,0,22,0,5,0,12,0,0,17,39
2022,Ecuador,ECU,Montenegro,MNE,0,5,0,0,0,0,5,0,0,0,0,0,0,0,5
2022,Ghana,GHA,Montenegro,MNE,0,0,0,5,0,0,5,0,0,0,0,0,0,0,5
2022,Iran (Islamic Rep. of),IRN,Montenegro,MNE,5,0,0,0,0,0,5,0,0,0,13,0,0,13,18
2022,Morocco,MAR,Montenegro,MNE,0,0,0,0,0,0,0,0,0,0,6,0,0,6,6
2022,Pakistan,PAK,Montenegro,MNE,0,0,0,0,0,0,0,0,0,0,5,0,0,5,5
2022,Russian Federation,RUS,Montenegro,MNE,0,0,5,12,0,0,17,0,6,5,48,5,0,64,81
2022,Serbia and Kosovo: S/RES/1244 (1999),SRB,Montenegro,MNE,0,0,20,0,0,0,20,0,5,8,19,0,0,32,52
2022,Türkiye,TUR,Montenegro,MNE,0,0,0,0,0,0,0,0,0,0,7,0,0,7,7
2022,Ukraine,UKR,Montenegro,MNE,0,10,0,0,0,5091,5101,0,0,0,0,0,2622,2622,32351
2022,Yemen,YEM,Montenegro,MNE,0,0,7,0,0,0,7,0,0,0,0,0,0,0,7
2022,Afghanistan,AFG,Mongolia,MNG,0,0,0,0,0,0,0,0,0,0,5,0,0,5,5
2022,China,CHN,Mongolia,MNG,0,0,0,0,0,0,0,0,0,0,5,0,0,5,5
2022,Afghanistan,AFG,Morocco,MAR,0,5,0,10,0,0,15,0,0,0,15,0,0,15,30
2022,Algeria,DZA,Morocco,MAR,0,0,0,17,0,0,17,0,0,5,8,0,0,13,30
2022,Angola,AGO,Morocco,MAR,0,0,0,0,0,0,0,0,0,5,0,0,0,5,5
2022,Egypt,EGY,Morocco,MAR,0,0,0,0,0,0,0,0,0,0,18,0,0,18,18
2022,Burundi,BDI,Morocco,MAR,9,0,0,0,0,0,9,0,0,0,0,0,0,0,9
2022,Benin,BEN,Morocco,MAR,0,0,0,0,0,0,0,0,0,0,7,0,0,7,7
2022,Bangladesh,BGD,Morocco,MAR,0,0,0,0,0,0,0,0,0,0,16,0,0,16,16
2022,Burkina Faso,BFA,Morocco,MAR,0,5,0,10,0,0,15,7,0,7,23,0,0,37,52
2022,Central African Rep.,CAF,Morocco,MAR,32,0,5,301,0,0,338,29,8,5,762,0,0,804,1142
2022,Chad,TCD,Morocco,MAR,5,0,0,8,0,0,13,0,0,40,65,0,0,105,118
2022,Cameroon,CMR,Morocco,MAR,40,26,7,147,0,0,220,44,24,29,462,0,0,559,779
2022,Congo,COG,Morocco,MAR,7,5,0,35,0,0,47,7,5,0,34,0,0,46,93
2022,Dem. Rep. of the Congo,COD,Morocco,MAR,15,22,15,100,0,0,152,21,21,18,165,9,0,234,386
2022,Eritrea,ERI,Morocco,MAR,0,0,0,16,0,0,16,0,0,14,55,0,0,69,85
2022,Ethiopia,ETH,Morocco,MAR,0,0,0,0,0,0,0,0,0,7,7,0,0,14,14
2022,Gabon,GAB,Morocco,MAR,0,0,0,0,0,0,0,0,0,0,9,0,0,9,9
2022,Gambia,GMB,Morocco,MAR,0,0,0,5,0,0,5,0,0,28,128,0,0,156,161
2022,Palestinian,PSE,Morocco,MAR,0,9,8,22,5,0,44,0,0,17,119,12,0,148,192
2022,Ghana,GHA,Morocco,MAR,0,0,0,0,0,0,0,0,0,0,6,0,0,6,6
2022,Guinea-Bissau,GNB,Morocco,MAR,0,0,0,0,0,0,0,0,0,14,62,0,0,76,76
2022,Guinea,GIN,Morocco,MAR,108,63,22,265,0,0,458,111,28,446,1316,0,0,1901,2359
2022,Cote d'Ivoire,CIV,Morocco,MAR,104,51,28,340,0,0,523,94,56,41,478,0,0,669,1192
2022,Iraq,IRQ,Morocco,MAR,0,6,0,34,6,0,46,0,0,5,61,21,0,87,133
2022,Jordan,JOR,Morocco,MAR,0,0,0,0,0,0,0,0,0,0,5,0,0,5,5
2022,Liberia,LBR,Morocco,MAR,0,0,0,5,0,0,5,0,0,5,33,0,0,38,43
2022,Libya,LBY,Morocco,MAR,0,5,6,6,0,0,17,0,8,0,29,5,0,42,59
2022,Lebanon,LBN,Morocco,MAR,0,0,9,7,0,0,16,0,6,13,11,0,0,30,46
2022,Mauritania,MRT,Morocco,MAR,0,0,0,0,0,0,0,0,0,0,16,0,0,16,16
2022,Mali,MLI,Morocco,MAR,11,5,5,42,0,0,63,18,15,52,501,0,0,586,649
2022,Niger,NER,Morocco,MAR,0,0,0,0,0,0,0,0,0,0,16,0,0,16,16
2022,Nigeria,NGA,Morocco,MAR,35,15,5,78,0,0,133,43,25,0,211,0,0,279,412
2022,Pakistan,PAK,Morocco,MAR,0,0,0,7,0,0,7,0,0,0,14,0,0,14,21
2022,Senegal,SEN,Morocco,MAR,11,5,5,55,0,0,76,6,5,96,1415,0,0,1522,1598
2022,Sierra Leone,SLE,Morocco,MAR,7,0,0,0,0,0,7,5,0,6,32,0,0,43,50
2022,Somalia,SOM,Morocco,MAR,5,0,5,14,0,0,24,0,0,11,16,0,0,27,51
2022,South Sudan,SSD,Morocco,MAR,0,0,0,91,0,0,91,0,0,11,262,0,0,273,364
2022,Sudan,SDN,Morocco,MAR,0,0,0,5,0,0,5,0,0,352,1007,0,0,1359,1364
2022,Syrian Arab Rep.,SYR,Morocco,MAR,320,489,309,1191,82,0,2391,365,501,345,1803,111,0,3125,5516
2022,Togo,TGO,Morocco,MAR,0,0,0,0,0,0,0,0,0,0,8,0,0,8,8
2022,Tunisia,TUN,Morocco,MAR,0,0,0,0,0,0,0,0,0,0,10,0,0,10,10
2022,Türkiye,TUR,Morocco,MAR,0,6,0,10,0,0,16,0,6,5,6,0,0,17,33
2022,Yemen,YEM,Morocco,MAR,26,48,22,101,0,0,197,13,37,54,586,6,0,696,893
2022,Angola,AGO,Mozambique,MOZ,0,0,0,5,0,0,5,0,0,0,0,0,0,0,5
2022,Burundi,BDI,Mozambique,MOZ,149,562,367,2303,52,0,3433,168,575,513,5158,68,0,6482,9915
2022,Central African Rep.,CAF,Mozambique,MOZ,0,0,0,0,0,0,0,0,0,0,8,0,0,8,8
2022,Congo,COG,Mozambique,MOZ,0,0,0,16,0,0,16,0,5,0,25,0,0,30,46
2022,Dem. Rep. of the Congo,COD,Mozambique,MOZ,237,913,671,2839,104,0,4764,237,921,653,4977,110,0,6898,11662
2022,Eritrea,ERI,Mozambique,MOZ,0,0,0,5,0,0,5,0,0,0,25,0,0,25,30
2022,Ethiopia,ETH,Mozambique,MOZ,0,9,0,0,0,0,9,0,0,0,16,0,0,16,25
2022,Palestinian,PSE,Mozambique,MOZ,0,0,0,0,0,0,0,0,0,9,0,0,0,9,9
2022,Guinea,GIN,Mozambique,MOZ,0,0,0,0,0,0,0,0,0,5,0,0,0,5,5
2022,Cote d'Ivoire,CIV,Mozambique,MOZ,0,10,0,156,0,0,166,0,0,7,349,0,0,356,522
2022,Mauritania,MRT,Mozambique,MOZ,0,0,0,0,0,0,0,0,0,0,5,0,0,5,5
2022,Rwanda,RWA,Mozambique,MOZ,42,193,122,1230,64,0,1651,56,188,125,2023,84,0,2476,4127
2022,Somalia,SOM,Mozambique,MOZ,37,153,30,660,0,0,880,42,155,46,3288,17,0,3548,4428
2022,South Sudan,SSD,Mozambique,MOZ,0,0,0,0,0,0,0,0,0,0,5,0,0,5,5
2022,Sudan,SDN,Mozambique,MOZ,0,12,0,0,0,0,12,0,0,0,24,0,0,24,36
2022,Syrian Arab Rep.,SYR,Mozambique,MOZ,0,6,0,0,0,0,6,0,0,0,0,0,0,0,6
2022,United Rep. of Tanzania,TZA,Mozambique,MOZ,0,0,0,0,0,0,0,0,0,0,5,0,0,5,5
2022,Türkiye,TUR,Mozambique,MOZ,0,5,0,8,0,0,13,5,0,0,7,5,0,17,30
2022,Uganda,UGA,Mozambique,MOZ,8,0,0,5,0,0,13,0,9,5,15,0,0,29,42
2022,Afghanistan,AFG,Malta,MLT,0,0,0,0,0,0,0,0,0,0,0,0,0,0,10
2022,Albania,ALB,Malta,MLT,0,0,0,0,0,0,0,0,0,0,0,0,0,0,5
2022,Algeria,DZA,Malta,MLT,0,0,0,0,0,15,15,0,0,0,0,0,15,15,30
2022,Egypt,EGY,Malta,MLT,0,0,0,0,0,21,21,0,0,0,0,0,63,63,158
2022,Armenia,ARM,Malta,MLT,0,0,0,0,0,0,0,0,0,0,0,0,0,0,5
2022,Bangladesh,BGD,Malta,MLT,0,0,0,0,0,0,0,0,0,0,0,0,0,0,189
2022,Burkina Faso,BFA,Malta,MLT,0,0,0,0,0,0,0,0,0,0,0,0,0,0,11
2022,Belarus,BLR,Malta,MLT,0,0,0,0,0,0,0,0,0,0,0,0,0,0,9
2022,Chad,TCD,Malta,MLT,0,0,0,0,0,0,0,0,0,0,0,0,0,0,24
2022,China,CHN,Malta,MLT,0,0,0,0,0,0,0,0,0,0,0,0,0,0,17
2022,Cameroon,CMR,Malta,MLT,0,0,0,0,0,6,6,0,0,0,0,0,15,15,31
2022,Dem. Rep. of the Congo,COD,Malta,MLT,0,0,0,0,0,0,0,0,0,0,0,0,0,0,12
2022,Comoros,COM,Malta,MLT,0,0,0,0,0,0,0,0,0,0,0,0,0,0,5
2022,Colombia,COL,Malta,MLT,0,0,0,0,0,8,8,0,0,0,0,0,7,7,15
2022,Eritrea,ERI,Malta,MLT,0,0,0,0,0,31,31,0,0,0,0,0,147,147,1089
2022,Ethiopia,ETH,Malta,MLT,0,0,0,0,0,15,15,0,0,0,0,0,18,18,207
2022,Gambia,GMB,Malta,MLT,0,0,0,0,0,0,0,0,0,0,0,0,0,0,102
2022,Palestinian,PSE,Malta,MLT,0,0,0,0,0,7,7,0,0,0,0,0,9,9,88
2022,Georgia,GEO,Malta,MLT,0,0,0,0,0,9,9,0,0,0,0,0,17,17,31
2022,Ghana,GHA,Malta,MLT,0,0,0,0,0,0,0,0,0,0,0,0,0,0,43
2022,Guinea,GIN,Malta,MLT,0,0,0,0,0,5,5,0,0,0,0,0,26,26,31
2022,Cote d'Ivoire,CIV,Malta,MLT,0,0,0,0,0,5,5,0,0,0,0,0,20,20,38
2022,Iran (Islamic Rep. of),IRN,Malta,MLT,0,0,0,0,0,0,0,0,0,0,0,0,9,9,41
2022,Iraq,IRQ,Malta,MLT,0,0,0,0,0,0,0,0,0,0,0,0,0,0,81
2022,Jordan,JOR,Malta,MLT,0,0,0,0,0,0,0,0,0,0,0,0,0,0,5
2022,Liberia,LBR,Malta,MLT,0,0,0,0,0,0,0,0,0,0,0,0,0,0,11
2022,Libya,LBY,Malta,MLT,0,0,0,0,0,39,39,0,0,0,0,0,93,93,2991
2022,Lebanon,LBN,Malta,MLT,0,0,0,0,0,0,0,0,0,0,0,0,0,0,5
2022,Sri Lanka,LKA,Malta,MLT,0,0,0,0,0,0,0,0,0,0,0,0,0,0,12
2022,North Macedonia,MKD,Malta,MLT,0,0,0,0,0,0,0,0,0,0,0,0,0,0,17
2022,Mali,MLI,Malta,MLT,0,0,0,0,0,6,6,0,0,0,0,0,38,38,64
2022,Morocco,MAR,Malta,MLT,0,0,0,0,0,20,20,0,0,0,0,0,60,60,110
2022,Nepal,NPL,Malta,MLT,0,0,0,0,0,5,5,0,0,0,0,0,14,14,19
2022,Niger,NER,Malta,MLT,0,0,0,0,0,0,0,0,0,0,0,0,0,0,24
2022,Nigeria,NGA,Malta,MLT,0,0,0,0,0,18,18,0,0,0,0,0,63,63,205
2022,Pakistan,PAK,Malta,MLT,0,0,0,0,0,6,6,0,0,0,0,0,29,29,94
2022,South Africa,ZAF,Malta,MLT,0,0,0,0,0,0,0,0,0,0,0,0,0,0,5
2022,Russian Federation,RUS,Malta,MLT,0,0,0,0,0,0,0,0,0,0,0,0,5,5,24
2022,Saudi Arabia,SAU,Malta,MLT,0,0,0,0,0,0,0,0,0,0,0,0,0,0,5
2022,Senegal,SEN,Malta,MLT,0,0,0,0,0,0,0,0,0,0,0,0,0,0,34
2022,Sierra Leone,SLE,Malta,MLT,0,0,0,0,0,5,5,0,0,0,0,0,21,21,31
2022,Somalia,SOM,Malta,MLT,0,0,0,0,0,9,9,0,0,0,0,0,54,54,1841
2022,Serbia and Kosovo: S/RES/1244 (1999),SRB,Malta,MLT,0,0,0,0,0,0,0,0,0,0,0,0,0,0,7
2022,South Sudan,SSD,Malta,MLT,0,0,0,0,0,0,0,0,0,0,0,0,0,0,42
2022,Sudan,SDN,Malta,MLT,0,0,0,0,0,5,5,0,0,0,0,0,150,150,381
2022,Syrian Arab Rep.,SYR,Malta,MLT,0,0,0,0,0,125,125,0,0,0,0,0,236,236,2349
2022,Togo,TGO,Malta,MLT,0,0,0,0,0,0,0,0,0,0,0,0,0,0,11
2022,Tunisia,TUN,Malta,MLT,0,0,0,0,0,0,0,0,0,0,0,0,0,0,18
2022,Türkiye,TUR,Malta,MLT,0,0,0,0,0,5,5,0,0,0,0,0,6,6,18
2022,Uganda,UGA,Malta,MLT,0,0,0,0,0,0,0,0,0,0,0,0,0,0,5
2022,Unknown ,UNK,Malta,MLT,0,0,0,0,0,0,0,0,0,0,0,0,0,0,637
2022,Ukraine,UKR,Malta,MLT,0,0,0,0,0,1202,1202,0,0,0,0,0,476,476,1819
2022,United States of America,USA,Malta,MLT,0,0,0,0,0,0,0,0,0,0,0,0,0,0,25
2022,Uzbekistan,UZB,Malta,MLT,0,0,0,0,0,0,0,0,0,0,0,0,0,0,5
2022,Venezuela (Bolivarian Republic of),VEN,Malta,MLT,0,0,0,0,0,23,23,0,0,0,0,0,20,20,67
2022,Yemen,YEM,Malta,MLT,0,0,0,0,0,5,5,0,0,0,0,0,0,0,10
2022,Zimbabwe,ZWE,Malta,MLT,0,0,0,0,0,0,0,0,0,0,0,0,0,0,5
2022,Angola,AGO,Namibia,NAM,0,0,0,5,0,0,5,0,0,0,0,0,0,0,5
2022,Burundi,BDI,Namibia,NAM,35,41,30,91,5,0,202,33,46,21,182,0,0,282,484
2022,Central African Rep.,CAF,Namibia,NAM,0,0,0,0,0,0,0,0,0,8,6,0,0,14,14
2022,Cameroon,CMR,Namibia,NAM,0,0,0,14,0,0,14,0,0,5,31,0,0,36,50
2022,Congo,COG,Namibia,NAM,0,5,0,0,0,0,5,5,5,0,0,0,0,10,15
2022,Dem. Rep. of the Congo,COD,Namibia,NAM,498,658,414,1332,36,0,2938,496,610,446,1757,36,0,3345,6283
2022,Ethiopia,ETH,Namibia,NAM,0,0,0,0,0,0,0,0,0,0,6,0,0,6,6
2022,Kenya,KEN,Namibia,NAM,0,0,0,0,0,0,0,5,0,0,5,0,0,10,10
2022,Nigeria,NGA,Namibia,NAM,0,0,0,0,0,0,0,0,0,0,5,0,0,5,5
2022,Rwanda,RWA,Namibia,NAM,7,17,8,43,0,0,75,0,15,6,70,7,0,98,173
2022,Somalia,SOM,Namibia,NAM,0,0,0,0,0,0,0,0,0,0,10,0,0,10,10
2022,South Sudan,SSD,Namibia,NAM,0,0,0,5,0,0,5,0,0,0,0,0,0,0,5
2022,Sudan,SDN,Namibia,NAM,0,0,0,0,0,0,0,0,7,0,0,0,0,7,7
2022,United Rep. of Tanzania,TZA,Namibia,NAM,0,0,0,0,5,0,5,0,0,0,0,0,0,0,5
2022,Uganda,UGA,Namibia,NAM,0,0,0,5,0,0,5,0,0,0,13,0,0,13,18
2022,Zimbabwe,ZWE,Namibia,NAM,0,0,12,36,0,0,48,0,0,16,43,0,0,59,107
2022,Afghanistan,AFG,Nepal,NPL,0,9,0,16,0,0,25,0,5,5,17,0,0,27,52
2022,Bhutan,BTN,Nepal,NPL,125,370,346,1764,352,0,2957,126,387,417,1950,528,0,3408,6365
2022,Iran (Islamic Rep. of),IRN,Nepal,NPL,0,0,0,0,0,0,0,0,0,0,9,0,0,9,9
2022,Sri Lanka,LKA,Nepal,NPL,0,6,0,5,0,0,11,0,0,0,10,0,0,10,21
2022,Myanmar,MMR,Nepal,NPL,45,43,28,104,6,0,226,38,46,32,118,5,0,239,465
2022,Pakistan,PAK,Nepal,NPL,0,16,11,60,5,0,92,7,17,11,81,8,0,124,216
2022,Russian Federation,RUS,Nepal,NPL,0,0,0,0,0,0,0,5,0,0,0,0,0,5,5
2022,Somalia,SOM,Nepal,NPL,0,0,0,8,0,0,8,0,5,0,18,0,0,23,31
2022,Tibetan,TIB,Nepal,NPL,0,0,0,0,0,6897,6897,0,0,0,0,0,5643,5643,12540
2022,Ukraine,UKR,Nepal,NPL,0,0,0,5,0,0,5,0,0,0,0,0,0,0,5
2022,Yemen,YEM,Nepal,NPL,0,0,0,0,0,0,0,0,5,0,0,0,0,5,5
2022,Afghanistan,AFG,Netherlands (Kingdom of the),NLD,0,0,0,0,0,237,237,0,0,0,0,0,746,746,9403
2022,Albania,ALB,Netherlands (Kingdom of the),NLD,0,0,0,0,0,0,0,0,0,0,0,0,8,8,16
2022,Algeria,DZA,Netherlands (Kingdom of the),NLD,0,0,0,0,0,23,23,0,0,0,0,0,884,884,1329
2022,Angola,AGO,Netherlands (Kingdom of the),NLD,0,0,0,0,0,5,5,0,0,0,0,0,10,10,43
2022,Egypt,EGY,Netherlands (Kingdom of the),NLD,0,0,0,0,0,77,77,0,0,0,0,0,201,201,859
2022,Argentina,ARG,Netherlands (Kingdom of the),NLD,0,0,0,0,0,5,5,0,0,0,0,0,0,0,15
2022,Armenia,ARM,Netherlands (Kingdom of the),NLD,0,0,0,0,0,14,14,0,0,0,0,0,23,23,271
2022,Azerbaijan,AZE,Netherlands (Kingdom of the),NLD,0,0,0,0,0,40,40,0,0,0,0,0,79,79,468
2022,Bahrain,BHR,Netherlands (Kingdom of the),NLD,0,0,0,0,0,0,0,0,0,0,0,0,0,0,14
2022,Burundi,BDI,Netherlands (Kingdom of the),NLD,0,0,0,0,0,10,10,0,0,0,0,0,13,13,100
2022,Benin,BEN,Netherlands (Kingdom of the),NLD,0,0,0,0,0,6,6,0,0,0,0,0,5,5,11
2022,Bangladesh,BGD,Netherlands (Kingdom of the),NLD,0,0,0,0,0,0,0,0,0,0,0,0,21,21,157
2022,Bhutan,BTN,Netherlands (Kingdom of the),NLD,0,0,0,0,0,0,0,0,0,0,0,0,0,0,40
2022,Burkina Faso,BFA,Netherlands (Kingdom of the),NLD,0,0,0,0,0,0,0,0,0,0,0,0,5,5,16
2022,Belarus,BLR,Netherlands (Kingdom of the),NLD,0,0,0,0,0,40,40,0,0,0,0,0,62,62,210
2022,Bolivia (Plurinational State of),BOL,Netherlands (Kingdom of the),NLD,0,0,0,0,0,5,5,0,0,0,0,0,0,0,5
2022,Brazil,BRA,Netherlands (Kingdom of the),NLD,0,0,0,0,0,8,8,0,0,0,0,0,0,0,16
2022,Bosnia and Herzegovina,BIH,Netherlands (Kingdom of the),NLD,0,0,0,0,0,0,0,0,0,0,0,0,0,0,8
2022,Cambodia,KHM,Netherlands (Kingdom of the),NLD,0,0,0,0,0,5,5,0,0,0,0,0,0,0,11
2022,Central African Rep.,CAF,Netherlands (Kingdom of the),NLD,0,0,0,0,0,0,0,0,0,0,0,0,5,5,12
2022,Chad,TCD,Netherlands (Kingdom of the),NLD,0,0,0,0,0,0,0,0,0,0,0,0,12,12,17
2022,China,CHN,Netherlands (Kingdom of the),NLD,0,0,0,0,0,66,66,0,0,0,0,0,71,71,914
2022,Chile,CHL,Netherlands (Kingdom of the),NLD,0,0,0,0,0,0,0,0,0,0,0,0,6,6,6
2022,Cameroon,CMR,Netherlands (Kingdom of the),NLD,0,0,0,0,0,6,6,0,0,0,0,0,21,21,129
2022,Congo,COG,Netherlands (Kingdom of the),NLD,0,0,0,0,0,18,18,0,0,0,0,0,12,12,205
2022,Dem. Rep. of the Congo,COD,Netherlands (Kingdom of the),NLD,0,0,0,0,0,16,16,0,0,0,0,0,17,17,116
2022,Colombia,COL,Netherlands (Kingdom of the),NLD,0,0,0,0,0,247,247,0,0,0,0,0,222,222,658
2022,Cuba,CUB,Netherlands (Kingdom of the),NLD,0,0,0,0,0,6,6,0,0,0,0,0,11,11,82
2022,Ecuador,ECU,Netherlands (Kingdom of the),NLD,0,0,0,0,0,0,0,0,0,0,0,0,0,0,7
2022,Eritrea,ERI,Netherlands (Kingdom of the),NLD,0,0,0,0,0,292,292,0,0,0,0,0,1026,1026,16148
2022,Ethiopia,ETH,Netherlands (Kingdom of the),NLD,0,0,0,0,0,93,93,0,0,0,0,0,212,212,741
2022,Gambia,GMB,Netherlands (Kingdom of the),NLD,0,0,0,0,0,17,17,0,0,0,0,0,128,128,201
2022,Palestinian,PSE,Netherlands (Kingdom of the),NLD,0,0,0,0,0,0,0,0,0,0,0,0,27,27,161
2022,United Kingdom of Great Britain and Northern Ireland,GBR,Netherlands (Kingdom of the),NLD,0,0,0,0,0,0,0,0,0,0,0,0,5,5,5
2022,Georgia,GEO,Netherlands (Kingdom of the),NLD,0,0,0,0,0,13,13,0,0,0,0,0,35,35,184
2022,Ghana,GHA,Netherlands (Kingdom of the),NLD,0,0,0,0,0,6,6,0,0,0,0,0,15,15,180
2022,Guinea-Bissau,GNB,Netherlands (Kingdom of the),NLD,0,0,0,0,0,0,0,0,0,0,0,0,5,5,5
2022,Guinea,GIN,Netherlands (Kingdom of the),NLD,0,0,0,0,0,26,26,0,0,0,0,0,86,86,445
2022,Guyana,GUY,Netherlands (Kingdom of the),NLD,0,0,0,0,0,0,0,0,0,0,0,0,5,5,11
2022,Haiti,HTI,Netherlands (Kingdom of the),NLD,0,0,0,0,0,5,5,0,0,0,0,0,0,0,5
2022,Honduras,HND,Netherlands (Kingdom of the),NLD,0,0,0,0,0,5,5,0,0,0,0,0,0,0,13
2022,Cote d'Ivoire,CIV,Netherlands (Kingdom of the),NLD,0,0,0,0,0,7,7,0,0,0,0,0,9,9,137
2022,India,IND,Netherlands (Kingdom of the),NLD,0,0,0,0,0,5,5,0,0,0,0,0,23,23,325
2022,Indonesia,IDN,Netherlands (Kingdom of the),NLD,0,0,0,0,0,0,0,0,0,0,0,0,0,0,13
2022,Iran (Islamic Rep. of),IRN,Netherlands (Kingdom of the),NLD,0,0,0,0,0,357,357,0,0,0,0,0,600,600,6350
2022,Iraq,IRQ,Netherlands (Kingdom of the),NLD,0,0,0,0,0,210,210,0,0,0,0,0,617,617,6154
2022,Israel,ISR,Netherlands (Kingdom of the),NLD,0,0,0,0,0,0,0,0,0,0,0,0,0,0,25
2022,Jamaica,JAM,Netherlands (Kingdom of the),NLD,0,0,0,0,0,7,7,0,0,0,0,0,7,7,174
2022,Jordan,JOR,Netherlands (Kingdom of the),NLD,0,0,0,0,0,31,31,0,0,0,0,0,62,62,219
2022,Kazakhstan,KAZ,Netherlands (Kingdom of the),NLD,0,0,0,0,0,23,23,0,0,0,0,0,16,16,107
2022,Kenya,KEN,Netherlands (Kingdom of the),NLD,0,0,0,0,0,7,7,0,0,0,0,0,8,8,55
2022,Kyrgyzstan,KGZ,Netherlands (Kingdom of the),NLD,0,0,0,0,0,5,5,0,0,0,0,0,7,7,43
2022,Dem. People's Rep. of Korea,PRK,Netherlands (Kingdom of the),NLD,0,0,0,0,0,0,0,0,0,0,0,0,5,5,10
2022,Kuwait,KWT,Netherlands (Kingdom of the),NLD,0,0,0,0,0,0,0,0,0,0,0,0,8,8,13
2022,Liberia,LBR,Netherlands (Kingdom of the),NLD,0,0,0,0,0,0,0,0,0,0,0,0,9,9,44
2022,Libya,LBY,Netherlands (Kingdom of the),NLD,0,0,0,0,0,26,26,0,0,0,0,0,153,153,512
2022,Lebanon,LBN,Netherlands (Kingdom of the),NLD,0,0,0,0,0,32,32,0,0,0,0,0,49,49,266
2022,Sri Lanka,LKA,Netherlands (Kingdom of the),NLD,0,0,0,0,0,12,12,0,0,0,0,0,41,41,257
2022,Mauritania,MRT,Netherlands (Kingdom of the),NLD,0,0,0,0,0,0,0,0,0,0,0,0,0,0,13
2022,North Macedonia,MKD,Netherlands (Kingdom of the),NLD,0,0,0,0,0,7,7,0,0,0,0,0,0,0,7
2022,Rep. of Moldova,MDA,Netherlands (Kingdom of the),NLD,0,0,0,0,0,54,54,0,0,0,0,0,89,89,251
2022,Mexico,MEX,Netherlands (Kingdom of the),NLD,0,0,0,0,0,7,7,0,0,0,0,0,6,6,21
2022,Mali,MLI,Netherlands (Kingdom of the),NLD,0,0,0,0,0,0,0,0,0,0,0,0,18,18,32
2022,Malaysia,MYS,Netherlands (Kingdom of the),NLD,0,0,0,0,0,5,5,0,0,0,0,0,0,0,12
2022,Malawi,MWI,Netherlands (Kingdom of the),NLD,0,0,0,0,0,0,0,0,0,0,0,0,5,5,5
2022,Mongolia,MNG,Netherlands (Kingdom of the),NLD,0,0,0,0,0,0,0,0,0,0,0,0,0,0,27
2022,Morocco,MAR,Netherlands (Kingdom of the),NLD,0,0,0,0,0,26,26,0,0,0,0,0,374,374,1371
2022,Myanmar,MMR,Netherlands (Kingdom of the),NLD,0,0,0,0,0,20,20,0,0,0,0,0,35,35,250
2022,Nepal,NPL,Netherlands (Kingdom of the),NLD,0,0,0,0,0,0,0,0,0,0,0,0,0,0,83
2022,Niger,NER,Netherlands (Kingdom of the),NLD,0,0,0,0,0,0,0,0,0,0,0,0,14,14,24
2022,Nicaragua,NIC,Netherlands (Kingdom of the),NLD,0,0,0,0,0,29,29,0,0,0,0,0,26,26,107
2022,Nigeria,NGA,Netherlands (Kingdom of the),NLD,0,0,0,0,0,196,196,0,0,0,0,0,389,389,2412
2022,Pakistan,PAK,Netherlands (Kingdom of the),NLD,0,0,0,0,0,181,181,0,0,0,0,0,553,553,1857
2022,Peru,PER,Netherlands (Kingdom of the),NLD,0,0,0,0,0,5,5,0,0,0,0,0,13,13,27
2022,Philippines,PHL,Netherlands (Kingdom of the),NLD,0,0,0,0,0,10,10,0,0,0,0,0,0,0,21
2022,South Africa,ZAF,Netherlands (Kingdom of the),NLD,0,0,0,0,0,10,10,0,0,0,0,0,12,12,28
2022,Russian Federation,RUS,Netherlands (Kingdom of the),NLD,0,0,0,0,0,153,153,0,0,0,0,0,371,371,1402
2022,Rwanda,RWA,Netherlands (Kingdom of the),NLD,0,0,0,0,0,0,0,0,0,0,0,0,8,8,54
2022,El Salvador,SLV,Netherlands (Kingdom of the),NLD,0,0,0,0,0,33,33,0,0,0,0,0,41,41,124
2022,Saudi Arabia,SAU,Netherlands (Kingdom of the),NLD,0,0,0,0,0,18,18,0,0,0,0,0,13,13,82
2022,Senegal,SEN,Netherlands (Kingdom of the),NLD,0,0,0,0,0,5,5,0,0,0,0,0,14,14,34
2022,Sierra Leone,SLE,Netherlands (Kingdom of the),NLD,0,0,0,0,0,31,31,0,0,0,0,0,73,73,393
2022,Somalia,SOM,Netherlands (Kingdom of the),NLD,0,0,0,0,0,660,660,0,0,0,0,0,838,838,8233
2022,Serbia and Kosovo: S/RES/1244 (1999),SRB,Netherlands (Kingdom of the),NLD,0,0,0,0,0,5,5,0,0,0,0,0,6,6,25
2022,Viet Nam,VNM,Netherlands (Kingdom of the),NLD,0,0,0,0,0,6,6,0,0,0,0,0,0,0,33
2022,South Sudan,SSD,Netherlands (Kingdom of the),NLD,0,0,0,0,0,5,5,0,0,0,0,0,10,10,15
2022,Stateless,XXA,Netherlands (Kingdom of the),NLD,0,0,0,0,0,22,22,0,0,0,0,0,36,36,2701
2022,Sudan,SDN,Netherlands (Kingdom of the),NLD,0,0,0,0,0,43,43,0,0,0,0,0,194,194,904
2022,Suriname,SUR,Netherlands (Kingdom of the),NLD,0,0,0,0,0,0,0,0,0,0,0,0,7,7,7
2022,Syrian Arab Rep.,SYR,Netherlands (Kingdom of the),NLD,0,0,0,0,0,1633,1633,0,0,0,0,0,10339,10339,57118
2022,United Rep. of Tanzania,TZA,Netherlands (Kingdom of the),NLD,0,0,0,0,0,5,5,0,0,0,0,0,5,5,39
2022,Tajikistan,TJK,Netherlands (Kingdom of the),NLD,0,0,0,0,0,15,15,0,0,0,0,0,35,35,123
2022,Turkmenistan,TKM,Netherlands (Kingdom of the),NLD,0,0,0,0,0,6,6,0,0,0,0,0,16,16,428
2022,Togo,TGO,Netherlands (Kingdom of the),NLD,0,0,0,0,0,0,0,0,0,0,0,0,0,0,9
2022,Trinidad and Tobago,TTO,Netherlands (Kingdom of the),NLD,0,0,0,0,0,5,5,0,0,0,0,0,10,10,101
2022,Tunisia,TUN,Netherlands (Kingdom of the),NLD,0,0,0,0,0,16,16,0,0,0,0,0,217,217,309
2022,Türkiye,TUR,Netherlands (Kingdom of the),NLD,0,0,0,0,0,698,698,0,0,0,0,0,1663,1663,9009
2022,United Arab Emirates,ARE,Netherlands (Kingdom of the),NLD,0,0,0,0,0,0,0,0,0,0,0,0,5,5,5
2022,Uganda,UGA,Netherlands (Kingdom of the),NLD,0,0,0,0,0,113,113,0,0,0,0,0,122,122,705
2022,Unknown ,UNK,Netherlands (Kingdom of the),NLD,0,0,0,0,0,268,268,0,0,0,0,0,751,751,4224
2022,Ukraine,UKR,Netherlands (Kingdom of the),NLD,0,0,0,0,0,85552,85552,0,0,0,0,0,18057,18057,103647
2022,United States of America,USA,Netherlands (Kingdom of the),NLD,0,0,0,0,0,0,0,0,0,0,0,0,8,8,87
2022,Uzbekistan,UZB,Netherlands (Kingdom of the),NLD,0,0,0,0,0,11,11,0,0,0,0,0,44,44,199
2022,Venezuela (Bolivarian Republic of),VEN,Netherlands (Kingdom of the),NLD,0,0,0,0,0,92,92,0,0,0,0,0,108,108,332
2022,Yemen,YEM,Netherlands (Kingdom of the),NLD,0,0,0,0,0,231,231,0,0,0,0,0,1813,1813,5118
2022,Zambia,ZMB,Netherlands (Kingdom of the),NLD,0,0,0,0,0,6,6,0,0,0,0,0,0,0,18
2022,Zimbabwe,ZWE,Netherlands (Kingdom of the),NLD,0,0,0,0,0,14,14,0,0,0,0,0,0,0,84
2022,Benin,BEN,Niger,NER,0,0,0,0,0,0,0,0,0,0,5,0,0,5,5
2022,Burkina Faso,BFA,Niger,NER,1023,3416,2582,6604,580,0,14205,1060,3553,2450,3215,498,0,10776,24981
2022,Central African Rep.,CAF,Niger,NER,11,25,9,51,0,0,96,6,14,16,95,0,0,131,227
2022,Chad,TCD,Niger,NER,69,372,170,616,87,0,1314,86,332,173,467,63,0,1121,2435
2022,Cameroon,CMR,Niger,NER,13,33,5,61,0,0,112,5,23,15,70,0,0,113,225
2022,Congo,COG,Niger,NER,0,0,0,0,0,0,0,0,0,0,5,0,0,5,5
2022,Dem. Rep. of the Congo,COD,Niger,NER,5,14,6,23,0,0,48,0,13,0,20,5,0,38,86
2022,Eritrea,ERI,Niger,NER,6,13,0,101,0,0,120,7,5,13,265,0,0,290,410
2022,Ethiopia,ETH,Niger,NER,0,5,0,15,0,0,20,0,5,5,30,0,0,40,60
2022,Ghana,GHA,Niger,NER,0,0,0,0,0,0,0,0,0,0,5,0,0,5,5
2022,Guinea,GIN,Niger,NER,0,5,0,0,0,0,5,0,0,5,15,0,0,20,25
2022,Cote d'Ivoire,CIV,Niger,NER,6,0,8,0,0,0,14,0,0,0,8,0,0,8,22
2022,Liberia,LBR,Niger,NER,0,0,9,0,0,0,9,0,0,0,0,0,0,0,9
2022,Libya,LBY,Niger,NER,0,0,0,0,0,0,0,0,0,0,0,6,0,6,6
2022,Mali,MLI,Niger,NER,2705,9574,6884,15819,1365,0,36347,2733,9822,6763,8862,1302,0,29482,65829
2022,Nigeria,NGA,Niger,NER,11313,32668,17140,46295,3546,0,110962,11301,30600,14977,32186,4561,0,93625,204587
2022,Pakistan,PAK,Niger,NER,0,0,0,0,0,0,0,0,0,0,6,0,0,6,6
2022,Rwanda,RWA,Niger,NER,0,0,0,0,0,0,0,0,5,0,7,0,0,12,12
2022,Somalia,SOM,Niger,NER,0,0,9,20,0,0,29,8,0,5,24,0,0,37,66
2022,South Sudan,SSD,Niger,NER,0,0,5,5,0,0,10,0,0,0,19,0,0,19,29
2022,Sudan,SDN,Niger,NER,150,134,63,301,0,0,648,150,143,281,1703,5,0,2282,2930
2022,Syrian Arab Rep.,SYR,Niger,NER,0,0,0,0,0,0,0,0,0,5,5,5,0,15,15
2022,Togo,TGO,Niger,NER,0,0,0,5,0,0,5,0,0,0,20,0,0,20,25
2022,Yemen,YEM,Niger,NER,0,0,0,5,0,0,5,0,0,0,7,0,0,7,12
2022,Colombia,COL,Nicaragua,NIC,0,0,0,0,0,0,0,0,0,0,0,0,0,0,6
2022,Cuba,CUB,Nicaragua,NIC,0,0,0,0,0,0,0,0,0,0,0,0,0,0,14
2022,Guatemala,GTM,Nicaragua,NIC,0,0,0,0,0,0,0,0,0,0,0,0,0,0,7
2022,Honduras,HND,Nicaragua,NIC,0,0,0,0,0,0,0,0,0,0,0,0,0,0,100
2022,El Salvador,SLV,Nicaragua,NIC,0,0,0,0,0,0,0,0,0,0,0,0,0,0,309
2022,Afghanistan,AFG,Nigeria,NGA,0,0,0,0,0,0,0,0,0,0,5,0,0,5,5
2022,Egypt,EGY,Nigeria,NGA,0,0,0,0,0,0,0,0,0,0,9,0,0,9,9
2022,Benin,BEN,Nigeria,NGA,0,0,0,5,0,0,5,0,0,0,0,0,0,0,5
2022,Central African Rep.,CAF,Nigeria,NGA,29,117,106,360,23,0,635,44,120,101,253,0,0,518,1153
2022,Chad,TCD,Nigeria,NGA,0,6,12,21,0,0,39,0,8,6,62,5,0,81,120
2022,Cameroon,CMR,Nigeria,NGA,5238,10614,6473,22977,2028,0,47330,5204,10687,6050,16439,1300,0,39680,87010
2022,Congo,COG,Nigeria,NGA,0,0,5,0,0,0,5,0,0,0,5,0,0,5,10
2022,Dem. Rep. of the Congo,COD,Nigeria,NGA,8,44,66,213,0,0,331,12,56,40,300,25,0,433,764
2022,Eritrea,ERI,Nigeria,NGA,0,5,0,11,0,0,16,0,9,0,28,0,0,37,53
2022,Ethiopia,ETH,Nigeria,NGA,0,0,0,13,0,0,13,0,0,0,0,0,0,0,13
2022,Palestinian,PSE,Nigeria,NGA,0,0,5,0,0,0,5,0,0,0,36,5,0,41,46
2022,Ghana,GHA,Nigeria,NGA,0,0,0,10,0,0,10,0,0,0,0,0,0,0,10
2022,Guinea-Bissau,GNB,Nigeria,NGA,0,0,0,0,0,0,0,0,0,0,5,0,0,5,5
2022,Guinea,GIN,Nigeria,NGA,0,0,0,10,0,0,10,0,0,5,8,0,0,13,23
2022,Cote d'Ivoire,CIV,Nigeria,NGA,6,7,6,29,0,0,48,0,16,11,64,0,0,91,139
2022,Liberia,LBR,Nigeria,NGA,0,0,5,6,0,0,11,0,0,0,0,0,0,0,11
2022,Libya,LBY,Nigeria,NGA,0,0,0,0,0,0,0,0,5,0,5,0,0,10,10
2022,Lebanon,LBN,Nigeria,NGA,0,0,5,16,0,0,21,0,0,0,36,5,0,41,62
2022,Mali,MLI,Nigeria,NGA,5,11,5,29,0,0,50,0,6,19,91,8,0,124,174
2022,Niger,NER,Nigeria,NGA,105,283,141,288,15,0,832,90,257,103,142,15,0,607,1439
2022,Pakistan,PAK,Nigeria,NGA,0,0,0,0,0,0,0,0,0,0,5,0,0,5,5
2022,Sierra Leone,SLE,Nigeria,NGA,0,0,0,10,0,0,10,0,0,0,13,0,0,13,23
2022,Sudan,SDN,Nigeria,NGA,0,0,14,10,0,0,24,0,6,5,29,0,0,40,64
2022,Syrian Arab Rep.,SYR,Nigeria,NGA,31,33,12,140,0,0,216,13,56,5,943,16,0,1033,1249
2022,Turkmenistan,TKM,Nigeria,NGA,0,0,0,0,0,0,0,0,0,0,5,0,0,5,5
2022,Togo,TGO,Nigeria,NGA,0,5,0,6,0,0,11,0,0,6,10,5,0,21,32
2022,Türkiye,TUR,Nigeria,NGA,20,61,19,117,0,0,217,12,70,15,125,5,0,227,444
2022,Ukraine,UKR,Nigeria,NGA,0,0,0,0,5,0,5,0,0,0,0,0,0,0,5
2022,Yemen,YEM,Nigeria,NGA,0,0,0,5,0,0,5,0,0,0,5,0,0,5,10
2022,Afghanistan,AFG,Norway,NOR,0,0,0,0,0,58,58,0,0,0,0,0,399,399,3498
2022,Albania,ALB,Norway,NOR,0,0,0,0,0,0,0,0,0,0,0,0,0,0,18
2022,Algeria,DZA,Norway,NOR,0,0,0,0,0,0,0,0,0,0,0,0,0,0,14
2022,Angola,AGO,Norway,NOR,0,0,0,0,0,0,0,0,0,0,0,0,0,0,5
2022,Egypt,EGY,Norway,NOR,0,0,0,0,0,0,0,0,0,0,0,0,0,0,47
2022,Armenia,ARM,Norway,NOR,0,0,0,0,0,0,0,0,0,0,0,0,0,0,15
2022,Azerbaijan,AZE,Norway,NOR,0,0,0,0,0,0,0,0,0,0,0,0,0,0,45
2022,Burundi,BDI,Norway,NOR,0,0,0,0,0,0,0,0,0,0,0,0,0,0,31
2022,Bangladesh,BGD,Norway,NOR,0,0,0,0,0,0,0,0,0,0,0,0,0,0,5
2022,Belarus,BLR,Norway,NOR,0,0,0,0,0,5,5,0,0,0,0,0,5,5,26
2022,Bulgaria,BGR,Norway,NOR,0,0,0,0,0,0,0,0,0,0,0,0,0,0,8
2022,Central African Rep.,CAF,Norway,NOR,0,0,0,0,0,0,0,0,0,0,0,0,0,0,15
2022,China,CHN,Norway,NOR,0,0,0,0,0,9,9,0,0,0,0,0,9,9,306
2022,Cameroon,CMR,Norway,NOR,0,0,0,0,0,0,0,0,0,0,0,0,0,0,17
2022,Congo,COG,Norway,NOR,0,0,0,0,0,0,0,0,0,0,0,0,0,0,5
2022,Dem. Rep. of the Congo,COD,Norway,NOR,0,0,0,0,0,6,6,0,0,0,0,0,11,11,378
2022,Colombia,COL,Norway,NOR,0,0,0,0,0,66,66,0,0,0,0,0,65,65,180
2022,Cuba,CUB,Norway,NOR,0,0,0,0,0,0,0,0,0,0,0,0,0,0,5
2022,Czechia,CZE,Norway,NOR,0,0,0,0,0,0,0,0,0,0,0,0,0,0,5
2022,Eritrea,ERI,Norway,NOR,0,0,0,0,0,143,143,0,0,0,0,0,99,99,10518
2022,Ethiopia,ETH,Norway,NOR,0,0,0,0,0,35,35,0,0,0,0,0,40,40,1158
2022,Gambia,GMB,Norway,NOR,0,0,0,0,0,0,0,0,0,0,0,0,0,0,13
2022,Georgia,GEO,Norway,NOR,0,0,0,0,0,5,5,0,0,0,0,0,15,15,47
2022,Ghana,GHA,Norway,NOR,0,0,0,0,0,0,0,0,0,0,0,0,0,0,6
2022,Guinea-Bissau,GNB,Norway,NOR,0,0,0,0,0,0,0,0,0,0,0,0,0,0,5
2022,Guinea,GIN,Norway,NOR,0,0,0,0,0,0,0,0,0,0,0,0,0,0,24
2022,Honduras,HND,Norway,NOR,0,0,0,0,0,0,0,0,0,0,0,0,0,0,6
2022,Cote d'Ivoire,CIV,Norway,NOR,0,0,0,0,0,0,0,0,0,0,0,0,0,0,13
2022,India,IND,Norway,NOR,0,0,0,0,0,0,0,0,0,0,0,0,0,0,5
2022,Iran (Islamic Rep. of),IRN,Norway,NOR,0,0,0,0,0,73,73,0,0,0,0,0,83,83,1525
2022,Iraq,IRQ,Norway,NOR,0,0,0,0,0,18,18,0,0,0,0,0,51,51,1019
2022,Israel,ISR,Norway,NOR,0,0,0,0,0,0,0,0,0,0,0,0,0,0,18
2022,Jordan,JOR,Norway,NOR,0,0,0,0,0,5,5,0,0,0,0,0,0,0,11
2022,Kazakhstan,KAZ,Norway,NOR,0,0,0,0,0,0,0,0,0,0,0,0,0,0,17
2022,Kenya,KEN,Norway,NOR,0,0,0,0,0,0,0,0,0,0,0,0,0,0,8
2022,Kyrgyzstan,KGZ,Norway,NOR,0,0,0,0,0,0,0,0,0,0,0,0,0,0,20
2022,Rep. of Korea,KOR,Norway,NOR,0,0,0,0,0,0,0,0,0,0,0,0,0,0,5
2022,Liberia,LBR,Norway,NOR,0,0,0,0,0,0,0,0,0,0,0,0,0,0,5
2022,Libya,LBY,Norway,NOR,0,0,0,0,0,0,0,0,0,0,0,0,0,0,61
2022,Lebanon,LBN,Norway,NOR,0,0,0,0,0,0,0,0,0,0,0,0,0,0,30
2022,Sri Lanka,LKA,Norway,NOR,0,0,0,0,0,0,0,0,0,0,0,0,0,0,47
2022,Lithuania,LTU,Norway,NOR,0,0,0,0,0,0,0,0,0,0,0,0,0,0,5
2022,Rep. of Moldova,MDA,Norway,NOR,0,0,0,0,0,0,0,0,0,0,0,0,0,0,27
2022,Mali,MLI,Norway,NOR,0,0,0,0,0,0,0,0,0,0,0,0,0,0,8
2022,Malaysia,MYS,Norway,NOR,0,0,0,0,0,0,0,0,0,0,0,0,0,0,5
2022,Morocco,MAR,Norway,NOR,0,0,0,0,0,6,6,0,0,0,0,0,9,9,31
2022,Myanmar,MMR,Norway,NOR,0,0,0,0,0,8,8,0,0,0,0,0,0,0,31
2022,Nepal,NPL,Norway,NOR,0,0,0,0,0,0,0,0,0,0,0,0,0,0,5
2022,Nicaragua,NIC,Norway,NOR,0,0,0,0,0,0,0,0,0,0,0,0,0,0,15
2022,Nigeria,NGA,Norway,NOR,0,0,0,0,0,7,7,0,0,0,0,0,6,6,117
2022,Pakistan,PAK,Norway,NOR,0,0,0,0,0,9,9,0,0,0,0,0,13,13,104
2022,Poland,POL,Norway,NOR,0,0,0,0,0,0,0,0,0,0,0,0,0,0,5
2022,Romania,ROU,Norway,NOR,0,0,0,0,0,0,0,0,0,0,0,0,0,0,5
2022,South Africa,ZAF,Norway,NOR,0,0,0,0,0,0,0,0,0,0,0,0,0,0,5
2022,Russian Federation,RUS,Norway,NOR,0,0,0,0,0,59,59,0,0,0,0,0,129,129,539
2022,Rwanda,RWA,Norway,NOR,0,0,0,0,0,0,0,0,0,0,0,0,0,0,13
2022,El Salvador,SLV,Norway,NOR,0,0,0,0,0,5,5,0,0,0,0,0,5,5,20
2022,Saudi Arabia,SAU,Norway,NOR,0,0,0,0,0,0,0,0,0,0,0,0,0,0,13
2022,Sierra Leone,SLE,Norway,NOR,0,0,0,0,0,0,0,0,0,0,0,0,0,0,8
2022,Solomon Islands,SLB,Norway,NOR,0,0,0,0,0,0,0,0,0,0,0,0,0,0,5
2022,Somalia,SOM,Norway,NOR,0,0,0,0,0,12,12,0,0,0,0,0,22,22,2173
2022,Serbia and Kosovo: S/RES/1244 (1999),SRB,Norway,NOR,0,0,0,0,0,0,0,0,0,0,0,0,0,0,27
2022,Viet Nam,VNM,Norway,NOR,0,0,0,0,0,0,0,0,0,0,0,0,0,0,38
2022,South Sudan,SSD,Norway,NOR,0,0,0,0,0,0,0,0,0,0,0,0,0,0,49
2022,Stateless,XXA,Norway,NOR,0,0,0,0,0,35,35,0,0,0,0,0,56,56,2283
2022,Sudan,SDN,Norway,NOR,0,0,0,0,0,5,5,0,0,0,0,0,10,10,1346
2022,Syrian Arab Rep.,SYR,Norway,NOR,0,0,0,0,0,165,165,0,0,0,0,0,1124,1124,17253
2022,Tajikistan,TJK,Norway,NOR,0,0,0,0,0,0,0,0,0,0,0,0,0,0,17
2022,Turkmenistan,TKM,Norway,NOR,0,0,0,0,0,0,0,0,0,0,0,0,0,0,12
2022,Türkiye,TUR,Norway,NOR,0,0,0,0,0,55,55,0,0,0,0,0,115,115,1368
2022,United Arab Emirates,ARE,Norway,NOR,0,0,0,0,0,0,0,0,0,0,0,0,0,0,5
2022,Uganda,UGA,Norway,NOR,0,0,0,0,0,0,0,0,0,0,0,0,0,0,99
2022,Unknown ,UNK,Norway,NOR,0,0,0,0,0,0,0,0,0,0,0,0,0,0,28
2022,Ukraine,UKR,Norway,NOR,0,0,0,0,0,20940,20940,0,0,0,0,0,12300,12300,33253
2022,United States of America,USA,Norway,NOR,0,0,0,0,0,0,0,0,0,0,0,0,0,0,5
2022,Uzbekistan,UZB,Norway,NOR,0,0,0,0,0,11,11,0,0,0,0,0,11,11,166
2022,Venezuela (Bolivarian Republic of),VEN,Norway,NOR,0,0,0,0,0,48,48,0,0,0,0,0,43,43,119
2022,Yemen,YEM,Norway,NOR,0,0,0,0,0,6,6,0,0,0,0,0,19,19,222
2022,Zimbabwe,ZWE,Norway,NOR,0,0,0,0,0,0,0,0,0,0,0,0,0,0,16
2022,Afghanistan,AFG,Nauru,NRU,0,0,0,0,0,0,0,0,0,0,5,0,0,5,5
2022,Bangladesh,BGD,Nauru,NRU,0,0,0,0,0,0,0,0,0,0,14,0,0,14,14
2022,Iran (Islamic Rep. of),IRN,Nauru,NRU,0,0,0,0,0,0,0,0,0,0,8,0,0,8,8
2022,Sri Lanka,LKA,Nauru,NRU,0,0,0,0,0,0,0,0,0,0,11,0,0,11,11
2022,Myanmar,MMR,Nauru,NRU,0,0,0,0,0,0,0,0,0,0,5,0,0,5,5
2022,Nepal,NPL,Nauru,NRU,0,0,0,0,0,0,0,0,0,0,5,0,0,5,5
2022,Pakistan,PAK,Nauru,NRU,0,0,0,0,0,0,0,0,0,0,14,0,0,14,14
2022,Somalia,SOM,Nauru,NRU,0,0,0,0,0,0,0,0,0,0,5,0,0,5,5
2022,Afghanistan,AFG,New Zealand,NZL,0,0,0,0,0,0,0,0,0,0,0,0,0,0,74
2022,Egypt,EGY,New Zealand,NZL,0,0,0,0,0,0,0,0,0,0,0,0,0,0,16
2022,Bahrain,BHR,New Zealand,NZL,0,0,0,0,0,0,0,0,0,0,0,0,0,0,12
2022,Bangladesh,BGD,New Zealand,NZL,0,0,0,0,0,0,0,0,0,0,5,0,0,5,24
2022,China,CHN,New Zealand,NZL,0,0,0,5,0,0,5,0,0,0,0,0,0,0,351
2022,Chile,CHL,New Zealand,NZL,0,0,0,0,0,0,0,0,0,0,0,0,0,0,5
2022,Cameroon,CMR,New Zealand,NZL,0,0,0,0,0,0,0,0,0,0,0,0,0,0,5
2022,Dem. Rep. of the Congo,COD,New Zealand,NZL,0,0,0,0,0,0,0,0,0,0,0,0,0,0,5
2022,Colombia,COL,New Zealand,NZL,0,0,0,0,0,0,0,0,0,0,0,0,0,0,38
2022,Czechia,CZE,New Zealand,NZL,0,0,0,0,0,0,0,0,0,0,0,0,0,0,9
2022,Eritrea,ERI,New Zealand,NZL,0,0,0,0,0,0,0,0,0,0,0,0,0,0,11
2022,Ethiopia,ETH,New Zealand,NZL,0,0,0,0,0,0,0,0,0,0,5,0,0,5,19
2022,Fiji,FJI,New Zealand,NZL,0,0,0,0,0,0,0,0,0,0,0,0,0,0,41
2022,Palestinian,PSE,New Zealand,NZL,0,0,0,0,0,0,0,0,0,0,0,0,0,0,6
2022,"China, Hong Kong SAR",HKG,New Zealand,NZL,0,0,0,0,0,0,0,0,0,0,0,0,0,0,10
2022,Hungary,HUN,New Zealand,NZL,0,0,0,0,0,0,0,0,0,0,0,0,0,0,5
2022,India,IND,New Zealand,NZL,0,0,0,0,0,0,0,0,0,0,6,0,0,6,144
2022,Indonesia,IDN,New Zealand,NZL,0,0,0,0,0,0,0,0,0,0,0,0,0,0,19
2022,Iran (Islamic Rep. of),IRN,New Zealand,NZL,0,0,0,0,0,0,0,0,0,0,0,0,0,0,88
2022,Iraq,IRQ,New Zealand,NZL,0,0,0,0,0,0,0,0,0,0,0,0,0,0,55
2022,Jordan,JOR,New Zealand,NZL,0,0,0,0,0,0,0,0,0,0,0,0,0,0,8
2022,Kiribati,KIR,New Zealand,NZL,0,0,0,0,0,0,0,0,0,0,0,0,0,0,5
2022,Kuwait,KWT,New Zealand,NZL,0,0,0,0,0,0,0,0,0,0,0,0,0,0,7
2022,Libya,LBY,New Zealand,NZL,0,0,0,0,0,0,0,0,0,0,0,0,0,0,20
2022,Sri Lanka,LKA,New Zealand,NZL,0,0,0,0,0,0,0,0,0,0,0,0,0,0,92
2022,Maldives,MDV,New Zealand,NZL,0,0,0,0,0,0,0,0,0,0,0,0,0,0,5
2022,Mexico,MEX,New Zealand,NZL,0,0,0,0,0,0,0,0,0,0,0,0,0,0,5
2022,Malaysia,MYS,New Zealand,NZL,0,0,0,0,0,0,0,0,0,0,0,0,0,0,52
2022,Mongolia,MNG,New Zealand,NZL,0,0,0,0,0,0,0,0,0,0,0,0,0,0,5
2022,Myanmar,MMR,New Zealand,NZL,0,0,0,0,0,0,0,0,0,0,0,0,0,0,36
2022,Nepal,NPL,New Zealand,NZL,0,0,0,0,0,0,0,0,0,0,0,0,0,0,5
2022,Pakistan,PAK,New Zealand,NZL,0,0,0,0,0,0,0,0,0,0,0,0,0,0,62
2022,Philippines,PHL,New Zealand,NZL,0,0,0,0,0,0,0,0,0,0,0,0,0,0,12
2022,Papua New Guinea,PNG,New Zealand,NZL,0,0,0,0,0,0,0,0,0,0,0,0,0,0,5
2022,South Africa,ZAF,New Zealand,NZL,0,0,0,0,0,0,0,0,0,0,0,0,0,0,12
2022,Russian Federation,RUS,New Zealand,NZL,0,0,0,0,0,0,0,0,0,0,0,0,0,0,50
2022,Saudi Arabia,SAU,New Zealand,NZL,0,0,0,0,0,0,0,0,0,0,0,0,0,0,63
2022,Somalia,SOM,New Zealand,NZL,0,0,0,0,0,0,0,0,0,0,0,0,0,0,9
2022,Viet Nam,VNM,New Zealand,NZL,0,0,0,0,0,0,0,0,0,0,0,0,0,0,12
2022,Stateless,XXA,New Zealand,NZL,0,0,0,0,0,0,0,0,0,0,0,0,0,0,5
2022,Sudan,SDN,New Zealand,NZL,0,0,0,0,0,0,0,0,0,0,0,0,0,0,9
2022,Syrian Arab Rep.,SYR,New Zealand,NZL,0,0,0,0,0,0,0,0,0,0,0,0,0,0,60
2022,Thailand,THA,New Zealand,NZL,0,0,0,0,0,0,0,0,0,6,0,0,0,6,6
2022,Tonga,TON,New Zealand,NZL,0,0,0,0,0,0,0,0,0,0,0,0,0,0,5
2022,Türkiye,TUR,New Zealand,NZL,0,0,0,0,0,0,0,0,0,0,0,0,0,0,54
2022,Uganda,UGA,New Zealand,NZL,0,0,0,0,0,0,0,0,0,0,0,0,0,0,21
2022,Unknown ,UNK,New Zealand,NZL,0,0,0,0,0,0,0,0,0,0,0,0,0,0,740
2022,Ukraine,UKR,New Zealand,NZL,0,0,0,0,0,0,0,0,0,0,0,0,0,0,22
2022,United States of America,USA,New Zealand,NZL,0,0,0,0,0,0,0,0,0,0,0,0,0,0,5
2022,Venezuela (Bolivarian Republic of),VEN,New Zealand,NZL,0,0,0,0,0,0,0,0,0,0,0,0,0,0,5
2022,Yemen,YEM,New Zealand,NZL,0,0,0,0,0,0,0,0,0,0,0,0,0,0,11
2022,Zimbabwe,ZWE,New Zealand,NZL,0,0,0,0,0,0,0,0,0,0,0,0,0,0,19
2022,Iraq,IRQ,Oman,OMN,0,28,65,228,27,0,348,0,40,39,239,26,0,344,692
2022,Pakistan,PAK,Oman,OMN,0,5,0,0,0,0,5,0,0,0,0,0,0,0,5
2022,Sudan,SDN,Oman,OMN,0,0,0,0,0,0,0,0,0,5,0,0,0,5,5
2022,Syrian Arab Rep.,SYR,Oman,OMN,0,0,0,14,0,0,14,0,0,0,0,0,0,0,14
2022,Afghanistan,AFG,Pakistan,PAK,100810,168024,102975,323023,22859,131916,849607,106761,177340,110343,350578,32524,154233,931779,1781386
2022,Algeria,DZA,Pakistan,PAK,0,0,0,9,0,0,9,0,0,0,8,5,0,13,22
2022,China,CHN,Pakistan,PAK,0,0,0,0,0,0,0,0,0,0,16,0,0,16,16
2022,Palestinian,PSE,Pakistan,PAK,0,0,0,0,0,0,0,0,0,5,16,0,0,21,21
2022,India,IND,Pakistan,PAK,0,0,0,5,0,0,5,0,0,0,0,0,0,0,5
2022,Iran (Islamic Rep. of),IRN,Pakistan,PAK,0,0,0,5,0,0,5,0,0,0,48,0,0,48,53
2022,Iraq,IRQ,Pakistan,PAK,0,0,0,0,0,0,0,0,0,0,28,0,0,28,28
2022,Sri Lanka,LKA,Pakistan,PAK,0,5,0,0,0,0,5,0,6,0,0,0,0,6,11
2022,Myanmar,MMR,Pakistan,PAK,0,12,0,12,0,0,24,0,14,0,17,0,0,31,55
2022,Russian Federation,RUS,Pakistan,PAK,0,0,0,6,0,0,6,0,0,0,0,0,0,0,6
2022,Somalia,SOM,Pakistan,PAK,0,6,10,52,5,0,73,0,10,7,111,0,0,128,201
2022,Syrian Arab Rep.,SYR,Pakistan,PAK,0,14,5,20,0,0,39,0,0,8,26,0,0,34,73
2022,United Rep. of Tanzania,TZA,Pakistan,PAK,0,5,0,0,0,0,5,0,0,0,0,0,0,0,5
2022,Tajikistan,TJK,Pakistan,PAK,0,7,0,0,0,0,7,0,0,0,0,0,0,0,7
2022,Türkiye,TUR,Pakistan,PAK,0,0,5,0,0,0,5,0,0,0,0,0,0,0,5
2022,Yemen,YEM,Pakistan,PAK,5,14,10,26,0,0,55,0,10,5,98,0,0,113,168
2022,Afghanistan,AFG,Panama,PAN,0,0,0,0,0,0,0,0,0,0,0,0,0,0,11
2022,Armenia,ARM,Panama,PAN,0,0,0,0,0,0,0,0,0,0,0,0,0,0,5
2022,Bangladesh,BGD,Panama,PAN,0,0,0,0,0,0,0,0,0,0,0,0,0,0,15
2022,Belarus,BLR,Panama,PAN,0,0,0,0,0,0,0,0,0,0,0,0,0,0,7
2022,Bosnia and Herzegovina,BIH,Panama,PAN,0,0,0,0,0,0,0,0,0,0,0,0,0,0,5
2022,Cameroon,CMR,Panama,PAN,0,0,0,0,0,0,0,0,0,0,0,0,0,0,15
2022,Dem. Rep. of the Congo,COD,Panama,PAN,0,0,0,0,0,0,0,0,0,0,0,0,0,0,10
2022,Colombia,COL,Panama,PAN,0,0,0,0,0,0,0,0,0,0,0,0,0,0,2486
2022,Cuba,CUB,Panama,PAN,0,0,0,0,0,0,0,0,0,0,0,0,0,0,1394
2022,Dominican Rep.,DOM,Panama,PAN,0,0,0,0,0,0,0,0,0,0,0,0,0,0,5
2022,Ecuador,ECU,Panama,PAN,0,0,0,0,0,0,0,0,0,0,0,0,0,0,10
2022,Eritrea,ERI,Panama,PAN,0,0,0,0,0,0,0,0,0,0,0,0,0,0,38
2022,Guatemala,GTM,Panama,PAN,0,0,0,0,0,0,0,0,0,0,0,0,0,0,18
2022,Haiti,HTI,Panama,PAN,0,0,0,0,0,0,0,0,0,0,0,0,0,0,19
2022,Honduras,HND,Panama,PAN,0,0,0,0,0,0,0,0,0,0,0,0,0,0,76
2022,Croatia,HRV,Panama,PAN,0,0,0,0,0,0,0,0,0,0,0,0,0,0,5
2022,Cote d'Ivoire,CIV,Panama,PAN,0,0,0,0,0,0,0,0,0,0,0,0,0,0,5
2022,India,IND,Panama,PAN,0,0,0,0,0,0,0,0,0,0,0,0,0,0,6
2022,Iran (Islamic Rep. of),IRN,Panama,PAN,0,0,0,0,0,0,0,0,0,0,0,0,0,0,5
2022,Italy,ITA,Panama,PAN,0,0,0,0,0,0,0,0,0,0,0,0,0,0,5
2022,Jamaica,JAM,Panama,PAN,0,0,0,0,0,0,0,0,0,0,0,0,0,0,5
2022,Liberia,LBR,Panama,PAN,0,0,0,0,0,0,0,0,0,0,0,0,0,0,5
2022,Sri Lanka,LKA,Panama,PAN,0,0,0,0,0,0,0,0,0,0,0,0,0,0,7
2022,Mexico,MEX,Panama,PAN,0,0,0,0,0,0,0,0,0,0,0,0,0,0,6
2022,Nepal,NPL,Panama,PAN,0,0,0,0,0,0,0,0,0,0,0,0,0,0,14
2022,Nicaragua,NIC,Panama,PAN,0,0,0,0,0,0,0,0,0,0,0,0,0,0,4461
2022,Nigeria,NGA,Panama,PAN,0,0,0,0,0,0,0,0,0,0,0,0,0,0,44
2022,Pakistan,PAK,Panama,PAN,0,0,0,0,0,0,0,0,0,0,0,0,0,0,13
2022,Peru,PER,Panama,PAN,0,0,0,0,0,0,0,0,0,0,0,0,0,0,23
2022,Russian Federation,RUS,Panama,PAN,0,0,0,0,0,0,0,0,0,0,0,0,0,0,12
2022,El Salvador,SLV,Panama,PAN,0,0,0,0,0,0,0,0,0,0,0,0,0,0,1253
2022,Sierra Leone,SLE,Panama,PAN,0,0,0,0,0,0,0,0,0,0,0,0,0,0,5
2022,Somalia,SOM,Panama,PAN,0,0,0,0,0,0,0,0,0,0,0,0,0,0,101
2022,Sudan,SDN,Panama,PAN,0,0,0,0,0,0,0,0,0,0,0,0,0,0,5
2022,Syrian Arab Rep.,SYR,Panama,PAN,0,0,0,0,0,0,0,0,0,0,0,0,0,0,5
2022,Ukraine,UKR,Panama,PAN,0,0,0,0,0,0,0,0,0,0,0,0,0,0,21
2022,Venezuela (Bolivarian Republic of),VEN,Panama,PAN,0,0,0,0,0,0,0,0,0,0,0,0,0,0,147627
2022,Afghanistan,AFG,Paraguay,PRY,0,0,5,5,0,0,10,0,0,0,5,0,0,5,15
2022,Argentina,ARG,Paraguay,PRY,0,0,0,5,0,0,5,0,0,0,7,0,0,7,17
2022,Bangladesh,BGD,Paraguay,PRY,0,0,0,0,0,0,0,0,0,0,0,0,0,0,5
2022,Bolivia (Plurinational State of),BOL,Paraguay,PRY,0,0,0,5,0,0,5,0,0,0,14,0,0,14,39
2022,Brazil,BRA,Paraguay,PRY,0,0,0,5,0,0,5,0,0,0,6,0,0,6,11
2022,Chile,CHL,Paraguay,PRY,0,0,0,0,0,0,0,0,5,0,0,0,0,5,5
2022,Cameroon,CMR,Paraguay,PRY,0,0,0,0,0,0,0,0,0,0,0,0,0,0,5
2022,Colombia,COL,Paraguay,PRY,5,10,5,62,0,0,82,0,5,5,154,5,0,169,285
2022,Cuba,CUB,Paraguay,PRY,10,41,22,366,14,0,453,5,26,23,621,15,0,690,1231
2022,Dominican Rep.,DOM,Paraguay,PRY,0,0,0,0,0,0,0,0,0,0,11,0,0,11,11
2022,Ecuador,ECU,Paraguay,PRY,0,0,0,0,0,0,0,0,0,0,7,0,0,7,7
2022,Guatemala,GTM,Paraguay,PRY,0,0,0,0,0,0,0,0,0,0,6,0,0,6,6
2022,Haiti,HTI,Paraguay,PRY,0,0,0,0,0,0,0,0,0,0,5,0,0,5,5
2022,Iraq,IRQ,Paraguay,PRY,0,0,0,0,0,0,0,0,0,0,0,0,0,0,6
2022,Lebanon,LBN,Paraguay,PRY,0,0,0,0,0,0,0,0,0,0,0,0,0,0,6
2022,Nigeria,NGA,Paraguay,PRY,0,0,0,0,0,0,0,0,0,0,0,0,0,0,5
2022,Peru,PER,Paraguay,PRY,15,0,0,5,0,0,20,10,0,0,14,0,0,24,44
2022,Poland,POL,Paraguay,PRY,0,0,0,8,0,0,8,0,0,0,0,0,0,0,8
2022,South Africa,ZAF,Paraguay,PRY,0,0,0,0,0,0,0,0,0,0,0,0,0,0,5
2022,El Salvador,SLV,Paraguay,PRY,0,0,0,7,0,0,7,0,0,0,10,0,0,10,17
2022,Syrian Arab Rep.,SYR,Paraguay,PRY,0,0,0,5,0,0,5,0,0,5,16,0,0,21,96
2022,Türkiye,TUR,Paraguay,PRY,0,0,0,5,0,0,5,0,0,0,0,0,0,0,10
2022,Ukraine,UKR,Paraguay,PRY,0,0,0,0,0,0,0,0,0,0,9,0,0,9,9
2022,Uruguay,URY,Paraguay,PRY,0,0,0,0,0,0,0,0,7,0,0,0,0,7,7
2022,Venezuela (Bolivarian Republic of),VEN,Paraguay,PRY,71,231,170,1505,132,0,2109,79,261,184,2039,88,0,2651,5769
2022,Afghanistan,AFG,Peru,PER,0,0,0,0,0,0,0,0,0,0,0,0,0,0,5
2022,Anguilla,AIA,Peru,PER,0,0,0,0,0,0,0,0,0,0,0,0,0,0,5
2022,Angola,AGO,Peru,PER,0,0,0,0,0,0,0,0,0,0,0,0,0,0,11
2022,Argentina,ARG,Peru,PER,0,0,0,0,0,0,0,0,0,0,0,0,0,0,15
2022,Bangladesh,BGD,Peru,PER,0,0,0,0,0,0,0,0,0,0,0,0,0,0,26
2022,Bolivia (Plurinational State of),BOL,Peru,PER,0,0,0,0,0,0,0,0,0,0,0,0,0,0,53
2022,Brazil,BRA,Peru,PER,0,0,0,0,0,0,0,0,0,0,0,0,0,0,21
2022,China,CHN,Peru,PER,0,0,0,0,0,0,0,0,0,0,0,0,0,0,13
2022,Chile,CHL,Peru,PER,0,0,0,0,0,0,0,0,0,0,0,0,0,0,12
2022,Cameroon,CMR,Peru,PER,0,0,0,0,0,0,0,0,0,0,0,0,0,0,20
2022,Congo,COG,Peru,PER,0,0,0,0,0,0,0,0,0,0,0,0,0,0,9
2022,Dem. Rep. of the Congo,COD,Peru,PER,0,0,0,0,0,0,0,0,0,0,0,0,0,0,8
2022,Colombia,COL,Peru,PER,0,0,0,0,0,0,0,0,0,0,0,0,0,0,2517
2022,Costa Rica,CRI,Peru,PER,0,0,0,0,0,0,0,0,0,0,0,0,0,0,5
2022,Cuba,CUB,Peru,PER,0,0,0,0,0,0,0,0,0,0,0,0,0,0,3555
2022,Dominica,DMA,Peru,PER,0,0,0,0,0,0,0,0,0,0,0,0,0,0,8
2022,Dominican Rep.,DOM,Peru,PER,0,0,0,0,0,0,0,0,0,0,0,0,0,0,75
2022,Ecuador,ECU,Peru,PER,0,0,0,0,0,0,0,0,0,0,0,0,0,0,285
2022,Ethiopia,ETH,Peru,PER,0,0,0,0,0,0,0,0,0,0,0,0,0,0,5
2022,Gambia,GMB,Peru,PER,0,0,0,0,0,0,0,0,0,0,0,0,0,0,5
2022,Palestinian,PSE,Peru,PER,0,0,0,0,0,0,0,0,0,0,0,0,0,0,49
2022,Germany,DEU,Peru,PER,0,0,0,0,0,0,0,0,0,0,0,0,0,0,5
2022,Ghana,GHA,Peru,PER,0,0,0,0,0,0,0,0,0,0,0,0,0,0,5
2022,Guatemala,GTM,Peru,PER,0,0,0,0,0,0,0,0,0,0,0,0,0,0,5
2022,Haiti,HTI,Peru,PER,0,0,0,0,0,0,0,0,0,0,0,0,0,0,164
2022,Honduras,HND,Peru,PER,0,0,0,0,0,0,0,0,0,0,0,0,0,0,8
2022,India,IND,Peru,PER,0,0,0,0,0,0,0,0,0,0,0,0,0,0,11
2022,Iran (Islamic Rep. of),IRN,Peru,PER,0,0,0,0,0,0,0,0,0,0,0,0,0,0,11
2022,Iraq,IRQ,Peru,PER,0,0,0,0,0,0,0,0,0,0,0,0,0,0,42
2022,Italy,ITA,Peru,PER,0,0,0,0,0,0,0,0,0,0,0,0,0,0,5
2022,Jordan,JOR,Peru,PER,0,0,0,0,0,0,0,0,0,0,0,0,0,0,5
2022,Sri Lanka,LKA,Peru,PER,0,0,0,0,0,0,0,0,0,0,0,0,0,0,7
2022,Mexico,MEX,Peru,PER,0,0,0,0,0,0,0,0,0,0,0,0,0,0,10
2022,Nepal,NPL,Peru,PER,0,0,0,0,0,0,0,0,0,0,0,0,0,0,5
2022,Nicaragua,NIC,Peru,PER,0,0,0,0,0,0,0,0,0,0,0,0,0,0,10
2022,Nigeria,NGA,Peru,PER,0,0,0,0,0,0,0,0,0,0,0,0,0,0,44
2022,Pakistan,PAK,Peru,PER,0,0,0,0,0,0,0,0,0,0,0,0,0,0,12
2022,Panama,PAN,Peru,PER,0,0,0,0,0,0,0,0,0,0,0,0,0,0,11
2022,Paraguay,PRY,Peru,PER,0,0,0,0,0,0,0,0,0,0,0,0,0,0,5
2022,Philippines,PHL,Peru,PER,0,0,0,0,0,0,0,0,0,0,0,0,0,0,21
2022,Poland,POL,Peru,PER,0,0,0,0,0,0,0,0,0,0,0,0,0,0,5
2022,Portugal,PRT,Peru,PER,0,0,0,0,0,0,0,0,0,0,0,0,0,0,16
2022,Russian Federation,RUS,Peru,PER,0,0,0,0,0,0,0,0,0,0,0,0,0,0,13
2022,El Salvador,SLV,Peru,PER,0,0,0,0,0,0,0,0,0,0,0,0,0,0,10
2022,Spain,ESP,Peru,PER,0,0,0,0,0,0,0,0,0,0,0,0,0,0,19
2022,Syrian Arab Rep.,SYR,Peru,PER,0,0,0,0,0,0,0,0,0,0,0,0,0,0,62
2022,Turkmenistan,TKM,Peru,PER,0,0,0,0,0,0,0,0,0,0,0,0,0,0,10
2022,Türkiye,TUR,Peru,PER,0,0,0,0,0,0,0,0,0,0,0,0,0,0,86
2022,United Arab Emirates,ARE,Peru,PER,0,0,0,0,0,0,0,0,0,0,0,0,0,0,5
2022,Unknown ,UNK,Peru,PER,0,0,0,0,0,0,0,0,0,0,0,0,0,0,27
2022,Ukraine,UKR,Peru,PER,0,0,0,0,0,0,0,0,0,0,0,0,0,0,36
2022,Uruguay,URY,Peru,PER,0,0,0,0,0,0,0,0,0,0,0,0,0,0,5
2022,United States of America,USA,Peru,PER,0,0,0,0,0,0,0,0,0,0,0,0,0,0,5
2022,Venezuela (Bolivarian Republic of),VEN,Peru,PER,0,0,0,0,0,0,0,0,0,0,0,0,0,0,1506368
2022,Yemen,YEM,Peru,PER,0,0,0,0,0,0,0,0,0,0,0,0,0,0,66
2022,Afghanistan,AFG,Philippines,PHL,0,0,5,0,0,0,5,0,0,0,5,0,0,5,10
2022,Egypt,EGY,Philippines,PHL,0,0,0,0,0,0,0,0,0,0,9,0,0,9,9
2022,Burundi,BDI,Philippines,PHL,0,5,8,0,0,0,13,0,0,0,0,0,0,0,13
2022,Cambodia,KHM,Philippines,PHL,0,0,0,5,0,0,5,0,0,0,8,0,0,8,13
2022,Chad,TCD,Philippines,PHL,0,0,0,0,0,0,0,0,0,0,8,0,0,8,8
2022,China,CHN,Philippines,PHL,0,0,0,5,0,0,5,0,0,0,5,0,0,5,10
2022,Cameroon,CMR,Philippines,PHL,0,16,0,15,0,0,31,0,0,0,108,0,0,108,139
2022,Congo,COG,Philippines,PHL,0,0,0,12,0,0,12,0,0,0,12,0,0,12,24
2022,Dem. Rep. of the Congo,COD,Philippines,PHL,7,0,0,17,0,0,24,0,0,0,16,0,0,16,40
2022,Eritrea,ERI,Philippines,PHL,0,5,0,16,0,0,21,0,0,0,21,0,0,21,42
2022,Ethiopia,ETH,Philippines,PHL,0,0,0,0,0,0,0,0,0,0,12,0,0,12,12
2022,France,FRA,Philippines,PHL,0,0,0,0,0,0,0,0,0,0,5,0,0,5,5
2022,Palestinian,PSE,Philippines,PHL,0,0,0,5,0,0,5,0,0,0,75,0,0,75,80
2022,Ghana,GHA,Philippines,PHL,0,0,0,0,0,0,0,0,0,0,5,0,0,5,5
2022,Guinea,GIN,Philippines,PHL,0,0,0,0,0,0,0,0,0,0,10,0,0,10,10
2022,Cote d'Ivoire,CIV,Philippines,PHL,10,0,0,22,0,0,32,0,0,0,45,0,0,45,77
2022,Iran (Islamic Rep. of),IRN,Philippines,PHL,0,0,0,22,0,0,22,0,0,0,72,11,0,83,105
2022,Iraq,IRQ,Philippines,PHL,0,5,0,14,0,0,19,0,0,5,44,6,0,55,74
2022,Kenya,KEN,Philippines,PHL,0,0,0,0,0,0,0,0,0,0,5,0,0,5,5
2022,Liberia,LBR,Philippines,PHL,9,0,0,0,0,0,9,0,0,0,5,0,0,5,14
2022,Libya,LBY,Philippines,PHL,0,0,0,0,0,0,0,0,0,0,5,0,0,5,5
2022,Lebanon,LBN,Philippines,PHL,0,0,0,5,0,0,5,0,0,0,12,5,0,17,22
2022,Sri Lanka,LKA,Philippines,PHL,0,0,0,6,0,0,6,0,0,0,13,0,0,13,19
2022,Malaysia,MYS,Philippines,PHL,0,0,0,0,0,0,0,0,0,0,5,0,0,5,5
2022,Morocco,MAR,Philippines,PHL,0,0,0,0,0,0,0,0,5,0,0,0,0,5,5
2022,Myanmar,MMR,Philippines,PHL,0,0,0,5,0,0,5,0,0,5,5,0,0,10,15
2022,Nigeria,NGA,Philippines,PHL,0,0,0,13,0,0,13,0,0,0,13,0,0,13,26
2022,Pakistan,PAK,Philippines,PHL,0,6,9,30,0,0,45,0,5,19,55,0,5,84,129
2022,Russian Federation,RUS,Philippines,PHL,0,0,0,9,0,0,9,0,0,0,5,0,0,5,14
2022,Rwanda,RWA,Philippines,PHL,0,0,0,0,0,0,0,0,0,0,18,0,0,18,18
2022,Saudi Arabia,SAU,Philippines,PHL,0,0,0,0,0,0,0,0,0,0,13,0,0,13,13
2022,Somalia,SOM,Philippines,PHL,0,0,0,10,0,0,10,0,0,0,56,0,0,56,66
2022,Viet Nam,VNM,Philippines,PHL,0,0,0,19,0,0,19,0,0,0,7,0,0,7,26
2022,Stateless,XXA,Philippines,PHL,0,0,0,5,0,0,5,0,0,0,5,0,0,5,10
2022,Sudan,SDN,Philippines,PHL,0,7,0,0,0,0,7,0,0,0,75,0,0,75,82
2022,Syrian Arab Rep.,SYR,Philippines,PHL,0,5,12,19,0,0,36,9,5,0,133,19,0,166,202
2022,Thailand,THA,Philippines,PHL,0,0,0,0,0,0,0,0,0,0,5,0,0,5,5
2022,Tunisia,TUN,Philippines,PHL,0,0,0,0,0,0,0,0,0,0,5,0,0,5,5
2022,Türkiye,TUR,Philippines,PHL,0,9,9,22,0,0,40,0,7,0,29,0,0,36,76
2022,United Arab Emirates,ARE,Philippines,PHL,0,0,0,0,0,0,0,0,0,0,13,0,0,13,13
2022,Uganda,UGA,Philippines,PHL,0,0,0,0,0,0,0,0,0,0,5,0,0,5,5
2022,Unknown ,UNK,Philippines,PHL,0,0,0,0,0,0,0,0,0,0,0,0,0,0,6
2022,Ukraine,UKR,Philippines,PHL,0,0,8,0,0,0,8,0,0,0,6,0,0,6,14
2022,United States of America,USA,Philippines,PHL,0,0,7,0,0,0,7,0,0,0,0,0,0,0,7
2022,Yemen,YEM,Philippines,PHL,6,0,0,11,0,0,17,0,5,0,131,0,0,136,153
2022,Afghanistan,AFG,Papua New Guinea,PNG,0,0,0,0,0,0,0,0,0,0,18,0,0,18,18
2022,Bangladesh,BGD,Papua New Guinea,PNG,0,0,0,0,0,0,0,0,0,0,5,0,0,5,5
2022,Indonesia,IDN,Papua New Guinea,PNG,0,0,0,0,0,0,0,0,0,0,0,0,0,0,13725
2022,Iran (Islamic Rep. of),IRN,Papua New Guinea,PNG,0,0,0,0,0,0,0,0,0,0,39,0,0,39,39
2022,Iraq,IRQ,Papua New Guinea,PNG,0,0,0,0,0,0,0,0,0,0,5,0,0,5,5
2022,Sri Lanka,LKA,Papua New Guinea,PNG,0,0,0,0,0,0,0,0,0,0,5,0,0,5,5
2022,Pakistan,PAK,Papua New Guinea,PNG,0,0,0,0,0,0,0,0,0,0,15,0,0,15,15
2022,Somalia,SOM,Papua New Guinea,PNG,0,0,0,0,0,0,0,0,0,0,5,0,0,5,5
2022,Sudan,SDN,Papua New Guinea,PNG,0,0,0,0,0,0,0,0,0,0,10,0,0,10,10
2022,Afghanistan,AFG,Poland,POL,0,0,0,0,0,0,0,0,0,0,0,0,0,0,1137
2022,Algeria,DZA,Poland,POL,0,0,0,0,0,0,0,0,0,0,0,0,0,0,35
2022,Angola,AGO,Poland,POL,0,0,0,0,0,0,0,0,0,0,0,0,0,0,6
2022,Egypt,EGY,Poland,POL,0,0,0,0,0,0,0,0,0,0,0,0,0,0,239
2022,Armenia,ARM,Poland,POL,0,0,0,0,0,0,0,0,0,0,0,0,0,0,201
2022,Australia,AUS,Poland,POL,0,0,0,0,0,0,0,0,0,0,0,0,0,0,5
2022,Azerbaijan,AZE,Poland,POL,0,0,0,0,0,0,0,0,0,0,0,0,0,0,310
2022,Bangladesh,BGD,Poland,POL,0,0,0,0,0,0,0,0,0,0,0,0,0,0,16
2022,Belarus,BLR,Poland,POL,0,0,0,0,0,0,0,0,0,0,0,0,0,0,6219
2022,Brazil,BRA,Poland,POL,0,0,0,0,0,0,0,0,0,0,0,0,0,0,5
2022,Bosnia and Herzegovina,BIH,Poland,POL,0,0,0,0,0,0,0,0,0,0,0,0,0,0,7
2022,Bulgaria,BGR,Poland,POL,0,0,0,0,0,0,0,0,0,0,0,0,0,0,5
2022,Canada,CAN,Poland,POL,0,0,0,0,0,0,0,0,0,0,0,0,0,0,20
2022,Central African Rep.,CAF,Poland,POL,0,0,0,0,0,0,0,0,0,0,0,0,0,0,5
2022,China,CHN,Poland,POL,0,0,0,0,0,0,0,0,0,0,0,0,0,0,32
2022,Chile,CHL,Poland,POL,0,0,0,0,0,0,0,0,0,0,0,0,0,0,25
2022,Cameroon,CMR,Poland,POL,0,0,0,0,0,0,0,0,0,0,0,0,0,0,33
2022,Congo,COG,Poland,POL,0,0,0,0,0,0,0,0,0,0,0,0,0,0,16
2022,Dem. Rep. of the Congo,COD,Poland,POL,0,0,0,0,0,0,0,0,0,0,0,0,0,0,22
2022,Colombia,COL,Poland,POL,0,0,0,0,0,0,0,0,0,0,0,0,0,0,5
2022,Costa Rica,CRI,Poland,POL,0,0,0,0,0,0,0,0,0,0,0,0,0,0,5
2022,Cuba,CUB,Poland,POL,0,0,0,0,0,0,0,0,0,0,0,0,0,0,30
2022,Ecuador,ECU,Poland,POL,0,0,0,0,0,0,0,0,0,0,0,0,0,0,5
2022,Eritrea,ERI,Poland,POL,0,0,0,0,0,0,0,0,0,0,0,0,0,0,10
2022,Ethiopia,ETH,Poland,POL,0,0,0,0,0,0,0,0,0,0,0,0,0,0,10
2022,Palestinian,PSE,Poland,POL,0,0,0,0,0,0,0,0,0,0,0,0,0,0,19
2022,United Kingdom of Great Britain and Northern Ireland,GBR,Poland,POL,0,0,0,0,0,0,0,0,0,0,0,0,0,0,25
2022,Georgia,GEO,Poland,POL,0,0,0,0,0,0,0,0,0,0,0,0,0,0,363
2022,Germany,DEU,Poland,POL,0,0,0,0,0,0,0,0,0,0,0,0,0,0,11
2022,Ghana,GHA,Poland,POL,0,0,0,0,0,0,0,0,0,0,0,0,0,0,11
2022,Guinea,GIN,Poland,POL,0,0,0,0,0,0,0,0,0,0,0,0,0,0,15
2022,India,IND,Poland,POL,0,0,0,0,0,0,0,0,0,0,0,0,0,0,99
2022,Iran (Islamic Rep. of),IRN,Poland,POL,0,0,0,0,0,0,0,0,0,0,0,0,0,0,167
2022,Iraq,IRQ,Poland,POL,0,0,0,0,0,0,0,0,0,0,0,0,0,0,309
2022,Israel,ISR,Poland,POL,0,0,0,0,0,0,0,0,0,0,0,0,0,0,60
2022,Jordan,JOR,Poland,POL,0,0,0,0,0,0,0,0,0,0,0,0,0,0,12
2022,Japan,JPN,Poland,POL,0,0,0,0,0,0,0,0,0,0,0,0,0,0,5
2022,Kazakhstan,KAZ,Poland,POL,0,0,0,0,0,0,0,0,0,0,0,0,0,0,122
2022,Kyrgyzstan,KGZ,Poland,POL,0,0,0,0,0,0,0,0,0,0,0,0,0,0,72
2022,Rep. of Korea,KOR,Poland,POL,0,0,0,0,0,0,0,0,0,0,0,0,0,0,5
2022,Lao People's Dem. Rep.,LAO,Poland,POL,0,0,0,0,0,0,0,0,0,0,0,0,0,0,5
2022,Libya,LBY,Poland,POL,0,0,0,0,0,0,0,0,0,0,0,0,0,0,30
2022,Lebanon,LBN,Poland,POL,0,0,0,0,0,0,0,0,0,0,0,0,0,0,36
2022,Sri Lanka,LKA,Poland,POL,0,0,0,0,0,0,0,0,0,0,0,0,0,0,38
2022,Rep. of Moldova,MDA,Poland,POL,0,0,0,0,0,0,0,0,0,0,0,0,0,0,300
2022,Mexico,MEX,Poland,POL,0,0,0,0,0,0,0,0,0,0,0,0,0,0,5
2022,Morocco,MAR,Poland,POL,0,0,0,0,0,0,0,0,0,0,0,0,0,0,44
2022,Nepal,NPL,Poland,POL,0,0,0,0,0,0,0,0,0,0,0,0,0,0,19
2022,Niger,NER,Poland,POL,0,0,0,0,0,0,0,0,0,0,0,0,0,0,25
2022,Nigeria,NGA,Poland,POL,0,0,0,0,0,0,0,0,0,0,0,0,0,0,35
2022,Pakistan,PAK,Poland,POL,0,0,0,0,0,0,0,0,0,0,0,0,0,0,84
2022,Philippines,PHL,Poland,POL,0,0,0,0,0,0,0,0,0,0,0,0,0,0,5
2022,South Africa,ZAF,Poland,POL,0,0,0,0,0,0,0,0,0,0,0,0,0,0,6
2022,Russian Federation,RUS,Poland,POL,0,0,0,0,0,0,0,0,0,0,0,0,0,0,3425
2022,Rwanda,RWA,Poland,POL,0,0,0,0,0,0,0,0,0,0,0,0,0,0,5
2022,Sierra Leone,SLE,Poland,POL,0,0,0,0,0,0,0,0,0,0,0,0,0,0,7
2022,Somalia,SOM,Poland,POL,0,0,0,0,0,0,0,0,0,0,0,0,0,0,24
2022,Serbia and Kosovo: S/RES/1244 (1999),SRB,Poland,POL,0,0,0,0,0,0,0,0,0,0,0,0,0,0,5
2022,Viet Nam,VNM,Poland,POL,0,0,0,0,0,0,0,0,0,0,0,0,0,0,115
2022,Stateless,XXA,Poland,POL,0,0,0,0,0,0,0,0,0,0,0,0,0,0,125
2022,Sudan,SDN,Poland,POL,0,0,0,0,0,0,0,0,0,0,0,0,0,0,22
2022,Syrian Arab Rep.,SYR,Poland,POL,0,0,0,0,0,0,0,0,0,0,0,0,0,0,308
2022,United Rep. of Tanzania,TZA,Poland,POL,0,0,0,0,0,0,0,0,0,0,0,0,0,0,5
2022,Tajikistan,TJK,Poland,POL,0,0,0,0,0,0,0,0,0,0,0,0,0,0,315
2022,Turkmenistan,TKM,Poland,POL,0,0,0,0,0,0,0,0,0,0,0,0,0,0,146
2022,Tunisia,TUN,Poland,POL,0,0,0,0,0,0,0,0,0,0,0,0,0,0,15
2022,Türkiye,TUR,Poland,POL,0,0,0,0,0,0,0,0,0,0,0,0,0,0,383
2022,Unknown ,UNK,Poland,POL,0,0,0,0,0,0,0,0,0,0,0,0,0,0,45
2022,Ukraine,UKR,Poland,POL,47907,86233,67070,364096,57489,0,622795,47907,95815,67071,105396,19163,0,335352,958519
2022,United States of America,USA,Poland,POL,0,0,0,0,0,0,0,0,0,0,0,0,0,0,100
2022,Uzbekistan,UZB,Poland,POL,0,0,0,0,0,0,0,0,0,0,0,0,0,0,188
2022,Venezuela (Bolivarian Republic of),VEN,Poland,POL,0,0,0,0,0,0,0,0,0,0,0,0,0,0,22
2022,Yemen,YEM,Poland,POL,0,0,0,0,0,0,0,0,0,0,0,0,0,0,40
2022,Zimbabwe,ZWE,Poland,POL,0,0,0,0,0,0,0,0,0,0,0,0,0,0,5
2022,Afghanistan,AFG,Portugal,PRT,0,0,0,0,0,0,0,0,0,0,0,0,0,0,880
2022,Algeria,DZA,Portugal,PRT,0,0,0,0,0,0,0,0,0,0,0,0,0,0,797
2022,Angola,AGO,Portugal,PRT,0,0,0,0,0,0,0,0,0,0,0,0,0,0,168
2022,Egypt,EGY,Portugal,PRT,0,0,0,0,0,0,0,0,0,0,0,0,0,0,130
2022,Armenia,ARM,Portugal,PRT,0,0,0,0,0,0,0,0,0,0,0,0,0,0,17
2022,Australia,AUS,Portugal,PRT,0,0,0,0,0,0,0,0,0,0,0,0,0,0,5
2022,Azerbaijan,AZE,Portugal,PRT,0,0,0,0,0,0,0,0,0,0,0,0,0,0,15
2022,Benin,BEN,Portugal,PRT,0,0,0,0,0,0,0,0,0,0,0,0,0,0,5
2022,Bangladesh,BGD,Portugal,PRT,0,0,0,0,0,0,0,0,0,0,0,0,0,0,171
2022,Belarus,BLR,Portugal,PRT,0,0,0,0,0,0,0,0,0,0,0,0,0,0,508
2022,Brazil,BRA,Portugal,PRT,0,0,0,0,0,8,8,0,0,0,0,0,8,8,39
2022,Canada,CAN,Portugal,PRT,0,0,0,0,0,0,0,0,0,0,0,0,0,0,24
2022,Central African Rep.,CAF,Portugal,PRT,0,0,0,0,0,0,0,0,0,0,0,0,0,0,8
2022,China,CHN,Portugal,PRT,0,0,0,0,0,0,0,0,0,0,0,0,0,0,70
2022,Cameroon,CMR,Portugal,PRT,0,0,0,0,0,0,0,0,0,0,0,0,0,0,248
2022,Congo,COG,Portugal,PRT,0,0,0,0,0,0,0,0,0,0,0,0,0,0,55
2022,Dem. Rep. of the Congo,COD,Portugal,PRT,0,0,0,0,0,0,0,0,0,0,0,0,0,0,177
2022,Comoros,COM,Portugal,PRT,0,0,0,0,0,0,0,0,0,0,0,0,0,0,5
2022,Colombia,COL,Portugal,PRT,0,0,0,0,0,35,35,0,0,0,0,0,34,34,90
2022,Cuba,CUB,Portugal,PRT,0,0,0,0,0,0,0,0,0,0,0,0,0,0,5
2022,Dominican Rep.,DOM,Portugal,PRT,0,0,0,0,0,6,6,0,0,0,0,0,7,7,13
2022,Ecuador,ECU,Portugal,PRT,0,0,0,0,0,0,0,0,0,0,0,0,0,0,33
2022,Eritrea,ERI,Portugal,PRT,0,0,0,0,0,0,0,0,0,0,0,0,0,0,204
2022,Ethiopia,ETH,Portugal,PRT,0,0,0,0,0,0,0,0,0,0,0,0,0,0,23
2022,Gabon,GAB,Portugal,PRT,0,0,0,0,0,0,0,0,0,0,0,0,0,0,5
2022,Gambia,GMB,Portugal,PRT,0,0,0,0,0,0,0,0,0,0,0,0,51,51,76
2022,Palestinian,PSE,Portugal,PRT,0,0,0,0,0,0,0,0,0,0,0,0,0,0,15
2022,United Kingdom of Great Britain and Northern Ireland,GBR,Portugal,PRT,0,0,0,0,0,0,0,0,0,0,0,0,0,0,9
2022,Georgia,GEO,Portugal,PRT,0,0,0,0,0,0,0,0,0,0,0,0,0,0,31
2022,Ghana,GHA,Portugal,PRT,0,0,0,0,0,0,0,0,0,0,0,0,0,0,575
2022,Guinea-Bissau,GNB,Portugal,PRT,0,0,0,0,0,0,0,0,0,0,0,0,20,20,29
2022,Guinea,GIN,Portugal,PRT,0,0,0,0,0,0,0,0,0,0,0,0,0,0,97
2022,Haiti,HTI,Portugal,PRT,0,0,0,0,0,0,0,0,0,0,0,0,0,0,6
2022,Cote d'Ivoire,CIV,Portugal,PRT,0,0,0,0,0,0,0,0,0,0,0,0,0,0,74
2022,India,IND,Portugal,PRT,0,0,0,0,0,20,20,0,0,0,0,0,58,58,977
2022,Iran (Islamic Rep. of),IRN,Portugal,PRT,0,0,0,0,0,0,0,0,0,0,0,0,20,20,120
2022,Iraq,IRQ,Portugal,PRT,0,0,0,0,0,0,0,0,0,0,0,0,0,0,245
2022,Israel,ISR,Portugal,PRT,0,0,0,0,0,0,0,0,0,0,0,0,0,0,27
2022,Jamaica,JAM,Portugal,PRT,0,0,0,0,0,0,0,0,0,0,0,0,0,0,12
2022,Jordan,JOR,Portugal,PRT,0,0,0,0,0,0,0,0,0,0,0,0,0,0,18
2022,Kazakhstan,KAZ,Portugal,PRT,0,0,0,0,0,0,0,0,0,0,0,0,0,0,14
2022,Kenya,KEN,Portugal,PRT,0,0,0,0,0,0,0,0,0,0,0,0,0,0,27
2022,Liberia,LBR,Portugal,PRT,0,0,0,0,0,0,0,0,0,0,0,0,0,0,29
2022,Libya,LBY,Portugal,PRT,0,0,0,0,0,0,0,0,0,0,0,0,0,0,33
2022,Lebanon,LBN,Portugal,PRT,0,0,0,0,0,0,0,0,0,0,0,0,0,0,16
2022,Sri Lanka,LKA,Portugal,PRT,0,0,0,0,0,0,0,0,0,0,0,0,0,0,35
2022,Rep. of Moldova,MDA,Portugal,PRT,0,0,0,0,0,0,0,0,0,0,0,0,0,0,58
2022,Mexico,MEX,Portugal,PRT,0,0,0,0,0,0,0,0,0,0,0,0,0,0,6
2022,Mali,MLI,Portugal,PRT,0,0,0,0,0,0,0,0,0,0,0,0,0,0,33
2022,Malawi,MWI,Portugal,PRT,0,0,0,0,0,0,0,0,0,0,0,0,0,0,5
2022,Morocco,MAR,Portugal,PRT,0,0,0,0,0,10,10,0,0,0,0,0,11,11,2096
2022,Myanmar,MMR,Portugal,PRT,0,0,0,0,0,0,0,0,0,0,0,0,0,0,5
2022,Namibia,NAM,Portugal,PRT,0,0,0,0,0,0,0,0,0,0,0,0,0,0,21
2022,Nepal,NPL,Portugal,PRT,0,0,0,0,0,0,0,0,0,0,0,0,0,0,165
2022,Nigeria,NGA,Portugal,PRT,0,0,0,0,0,0,0,0,0,0,0,0,0,0,3881
2022,Pakistan,PAK,Portugal,PRT,0,0,0,0,0,20,20,0,0,0,0,0,40,40,823
2022,Philippines,PHL,Portugal,PRT,0,0,0,0,0,0,0,0,0,0,0,0,0,0,5
2022,South Africa,ZAF,Portugal,PRT,0,0,0,0,0,0,0,0,0,0,0,0,0,0,12
2022,Russian Federation,RUS,Portugal,PRT,0,0,0,0,0,25,25,0,0,0,0,0,26,26,719
2022,Rwanda,RWA,Portugal,PRT,0,0,0,0,0,0,0,0,0,0,0,0,0,0,7
2022,Senegal,SEN,Portugal,PRT,0,0,0,0,0,0,0,0,0,0,0,0,23,23,29
2022,Sierra Leone,SLE,Portugal,PRT,0,0,0,0,0,0,0,0,0,0,0,0,0,0,62
2022,Somalia,SOM,Portugal,PRT,0,0,0,0,0,0,0,0,0,0,0,0,0,0,62
2022,South Sudan,SSD,Portugal,PRT,0,0,0,0,0,0,0,0,0,0,0,0,0,0,33
2022,Stateless,XXA,Portugal,PRT,0,0,0,0,0,0,0,0,0,0,0,0,0,0,24
2022,Sudan,SDN,Portugal,PRT,0,0,0,0,0,0,0,0,0,0,0,0,0,0,107
2022,Eswatini,SWZ,Portugal,PRT,0,0,0,0,0,0,0,0,0,0,0,0,0,0,25
2022,Syrian Arab Rep.,SYR,Portugal,PRT,0,0,0,0,0,0,0,0,0,0,0,0,0,0,933
2022,United Rep. of Tanzania,TZA,Portugal,PRT,0,0,0,0,0,0,0,0,0,0,0,0,0,0,15
2022,Tajikistan,TJK,Portugal,PRT,0,0,0,0,0,0,0,0,0,0,0,0,0,0,5
2022,Turkmenistan,TKM,Portugal,PRT,0,0,0,0,0,0,0,0,0,0,0,0,0,0,9
2022,Timor-Leste,TLS,Portugal,PRT,0,0,0,0,0,0,0,0,0,0,0,0,0,0,7
2022,Togo,TGO,Portugal,PRT,0,0,0,0,0,0,0,0,0,0,0,0,0,0,8
2022,Tunisia,TUN,Portugal,PRT,0,0,0,0,0,0,0,0,0,0,0,0,0,0,84
2022,Türkiye,TUR,Portugal,PRT,0,0,0,0,0,0,0,0,0,0,0,0,0,0,96
2022,Uganda,UGA,Portugal,PRT,0,0,0,0,0,0,0,0,0,0,0,0,0,0,7
2022,Unknown ,UNK,Portugal,PRT,0,0,0,0,0,0,0,0,0,0,0,0,0,0,28
2022,Ukraine,UKR,Portugal,PRT,0,0,0,0,0,29386,29386,0,0,0,0,0,15138,15138,44989
2022,United States of America,USA,Portugal,PRT,0,0,0,0,0,0,0,0,0,0,0,0,0,0,67
2022,Uzbekistan,UZB,Portugal,PRT,0,0,0,0,0,0,0,0,0,0,0,0,0,0,17
2022,Venezuela (Bolivarian Republic of),VEN,Portugal,PRT,0,0,0,0,0,13,13,0,0,0,0,0,14,14,32
2022,Yemen,YEM,Portugal,PRT,0,0,0,0,0,0,0,0,0,0,0,0,0,0,18
2022,Zambia,ZMB,Portugal,PRT,0,0,0,0,0,0,0,0,0,0,0,0,0,0,22
2022,Zimbabwe,ZWE,Portugal,PRT,0,0,0,0,0,0,0,0,0,0,0,0,0,0,70
2022,Egypt,EGY,Qatar,QAT,0,0,7,5,0,0,12,0,0,11,0,0,0,11,23
2022,Eritrea,ERI,Qatar,QAT,0,0,0,0,0,0,0,0,5,0,0,0,0,5,5
2022,Iraq,IRQ,Qatar,QAT,0,10,17,76,20,0,123,7,12,13,85,6,0,123,246
2022,Pakistan,PAK,Qatar,QAT,0,0,0,0,0,0,0,5,0,0,0,0,0,5,5
2022,Somalia,SOM,Qatar,QAT,0,0,0,8,0,0,8,0,0,0,0,0,0,0,8
2022,Sudan,SDN,Qatar,QAT,0,0,0,5,0,0,5,0,5,0,5,0,0,10,15
2022,Syrian Arab Rep.,SYR,Qatar,QAT,0,7,0,7,5,0,19,0,5,0,6,0,0,11,30
2022,Yemen,YEM,Qatar,QAT,0,0,0,0,0,0,0,0,5,0,0,0,0,5,5
2022,Afghanistan,AFG,Romania,ROU,19,28,19,90,5,0,161,13,17,35,189,5,0,259,525
2022,Algeria,DZA,Romania,ROU,0,0,0,0,0,0,0,0,0,0,5,0,0,5,10
2022,Angola,AGO,Romania,ROU,0,9,0,0,0,0,9,0,0,0,0,0,0,0,9
2022,Egypt,EGY,Romania,ROU,0,0,0,6,0,0,6,0,0,0,18,0,0,18,35
2022,Armenia,ARM,Romania,ROU,0,5,0,16,0,0,21,0,0,0,15,0,0,15,36
2022,Azerbaijan,AZE,Romania,ROU,0,0,0,22,0,0,22,0,0,0,28,0,0,28,50
2022,Burundi,BDI,Romania,ROU,0,0,0,0,0,0,0,0,0,0,6,0,0,6,6
2022,Bangladesh,BGD,Romania,ROU,0,0,0,5,0,0,5,0,0,0,8,0,0,8,145
2022,Belarus,BLR,Romania,ROU,0,0,0,25,0,0,25,0,5,0,14,0,0,19,44
2022,Canada,CAN,Romania,ROU,0,0,0,0,0,0,0,0,0,0,9,0,0,9,9
2022,Central African Rep.,CAF,Romania,ROU,0,0,0,0,0,0,0,0,0,0,5,0,0,5,5
2022,China,CHN,Romania,ROU,5,0,0,14,0,0,19,0,0,0,20,0,0,20,39
2022,Cameroon,CMR,Romania,ROU,0,0,5,7,0,0,12,0,0,0,14,0,0,14,34
2022,Congo,COG,Romania,ROU,0,0,0,0,0,0,0,0,0,0,5,0,0,5,5
2022,Dem. Rep. of the Congo,COD,Romania,ROU,0,0,0,9,0,0,9,0,0,0,7,0,0,7,16
2022,Cuba,CUB,Romania,ROU,0,0,0,0,0,0,0,0,0,0,6,0,0,6,6
2022,Ecuador,ECU,Romania,ROU,0,0,0,0,0,0,0,0,0,0,9,0,0,9,9
2022,Eritrea,ERI,Romania,ROU,0,0,0,15,0,0,15,0,0,0,52,0,0,52,67
2022,Ethiopia,ETH,Romania,ROU,0,0,0,7,0,0,7,0,0,0,0,0,0,0,14
2022,Gambia,GMB,Romania,ROU,0,0,0,0,0,0,0,0,5,0,0,0,0,5,5
2022,Palestinian,PSE,Romania,ROU,7,7,0,14,0,0,28,5,6,0,29,0,0,40,76
2022,United Kingdom of Great Britain and Northern Ireland,GBR,Romania,ROU,0,0,0,0,0,0,0,0,0,0,5,0,0,5,5
2022,Georgia,GEO,Romania,ROU,0,0,0,6,0,0,6,0,0,0,18,0,0,18,24
2022,Guinea,GIN,Romania,ROU,0,0,0,6,0,0,6,0,0,0,6,0,0,6,20
2022,Hungary,HUN,Romania,ROU,0,0,0,0,0,0,0,5,0,0,0,0,0,5,5
2022,India,IND,Romania,ROU,0,0,0,5,0,0,5,0,0,0,14,0,0,14,110
2022,Iran (Islamic Rep. of),IRN,Romania,ROU,0,5,6,30,0,0,41,5,8,5,67,7,0,92,143
2022,Iraq,IRQ,Romania,ROU,16,25,19,92,22,0,174,21,40,27,205,24,0,317,572
2022,Israel,ISR,Romania,ROU,0,8,0,5,0,0,13,0,5,0,11,0,0,16,29
2022,Jordan,JOR,Romania,ROU,0,0,0,0,0,0,0,0,0,0,12,0,0,12,12
2022,Kazakhstan,KAZ,Romania,ROU,0,0,0,6,0,0,6,0,0,0,0,0,0,0,6
2022,Kuwait,KWT,Romania,ROU,0,5,0,0,0,0,5,0,0,0,0,0,0,0,5
2022,Libya,LBY,Romania,ROU,0,0,0,0,0,0,0,0,5,0,0,0,0,5,5
2022,Lebanon,LBN,Romania,ROU,0,0,5,5,0,0,10,0,0,0,13,0,0,13,28
2022,Sri Lanka,LKA,Romania,ROU,0,0,0,0,0,0,0,0,0,0,5,0,0,5,58
2022,Rep. of Moldova,MDA,Romania,ROU,0,0,5,91,16,0,112,6,6,5,94,8,0,119,231
2022,Mexico,MEX,Romania,ROU,0,0,0,0,0,0,0,0,0,0,5,0,0,5,5
2022,Mali,MLI,Romania,ROU,0,0,0,0,0,0,0,0,0,0,6,0,0,6,6
2022,Morocco,MAR,Romania,ROU,0,0,0,0,0,0,0,0,0,0,9,0,0,9,27
2022,Myanmar,MMR,Romania,ROU,0,0,5,8,0,0,13,0,6,5,7,0,0,18,31
2022,Nepal,NPL,Romania,ROU,0,0,0,0,0,0,0,0,0,0,0,0,0,0,23
2022,Nigeria,NGA,Romania,ROU,0,0,0,0,0,0,0,0,0,0,12,0,0,12,20
2022,Pakistan,PAK,Romania,ROU,0,0,5,5,0,0,10,0,8,0,23,0,0,31,120
2022,Russian Federation,RUS,Romania,ROU,5,7,5,128,26,0,171,0,16,5,107,7,0,135,322
2022,Rwanda,RWA,Romania,ROU,0,0,0,7,0,0,7,0,0,6,0,0,0,6,13
2022,Sierra Leone,SLE,Romania,ROU,0,0,0,0,0,0,0,0,0,0,0,5,0,5,5
2022,Somalia,SOM,Romania,ROU,12,50,68,133,0,0,263,17,45,31,88,0,0,181,477
2022,Stateless,XXA,Romania,ROU,0,10,5,34,0,0,49,5,7,5,64,6,0,87,144
2022,Sudan,SDN,Romania,ROU,0,0,0,6,0,0,6,0,0,0,17,5,0,22,40
2022,Syrian Arab Rep.,SYR,Romania,ROU,102,137,88,502,52,0,881,96,145,106,1032,72,0,1451,2616
2022,Tajikistan,TJK,Romania,ROU,0,0,0,0,0,0,0,0,0,6,0,0,0,6,6
2022,Turkmenistan,TKM,Romania,ROU,0,0,0,9,0,0,9,0,0,0,12,0,0,12,21
2022,Tunisia,TUN,Romania,ROU,0,0,0,0,0,0,0,0,0,0,7,0,0,7,19
2022,Türkiye,TUR,Romania,ROU,8,0,0,24,0,0,32,0,5,6,49,6,0,66,206
2022,Uganda,UGA,Romania,ROU,0,0,0,0,0,0,0,0,7,0,0,0,0,7,7
2022,Unknown ,UNK,Romania,ROU,0,0,0,0,0,0,0,0,0,5,0,0,0,5,5
2022,Ukraine,UKR,Romania,ROU,4472,7787,4704,36433,7115,0,60511,4713,7955,4945,18735,3227,0,39575,100128
2022,United States of America,USA,Romania,ROU,8,0,0,5,0,0,13,9,0,0,14,9,0,32,45
2022,Uzbekistan,UZB,Romania,ROU,0,0,0,9,0,0,9,0,0,0,16,0,0,16,25
2022,Yemen,YEM,Romania,ROU,0,5,0,14,0,0,19,0,8,0,52,0,0,60,84
2022,Afghanistan,AFG,South Africa,ZAF,0,0,0,11,0,0,11,0,0,0,7,0,0,7,18
2022,Algeria,DZA,South Africa,ZAF,0,0,0,5,0,0,5,0,0,0,31,0,0,31,36
2022,Angola,AGO,South Africa,ZAF,0,0,0,9,0,0,9,0,0,0,18,0,0,18,27
2022,Egypt,EGY,South Africa,ZAF,0,5,0,0,0,0,5,0,0,0,56,0,0,56,61
2022,Burundi,BDI,South Africa,ZAF,8,167,236,1473,12,0,1896,0,159,241,4247,27,0,4674,6570
2022,Benin,BEN,South Africa,ZAF,0,0,0,5,0,0,5,0,0,0,10,0,0,10,15
2022,Bangladesh,BGD,South Africa,ZAF,0,0,0,84,0,0,84,0,7,7,9740,34,0,9788,9872
2022,Bahamas,BHS,South Africa,ZAF,0,0,0,0,0,0,0,0,0,0,7,0,0,7,7
2022,Burkina Faso,BFA,South Africa,ZAF,0,0,0,5,0,0,5,0,0,0,13,0,0,13,18
2022,Central African Rep.,CAF,South Africa,ZAF,0,0,0,8,0,0,8,0,0,0,5,0,0,5,13
2022,China,CHN,South Africa,ZAF,0,0,0,5,0,0,5,0,0,0,9,0,0,9,14
2022,Cameroon,CMR,South Africa,ZAF,0,10,15,368,0,0,393,0,5,18,625,5,0,653,1046
2022,Congo,COG,South Africa,ZAF,0,50,216,3281,67,0,3614,0,43,227,4685,92,0,5047,8661
2022,Dem. Rep. of the Congo,COD,South Africa,ZAF,39,1285,2113,14207,247,0,17891,38,1297,2012,20603,326,0,24276,42167
2022,Comoros,COM,South Africa,ZAF,0,0,0,0,0,0,0,0,0,0,9,0,0,9,9
2022,Eritrea,ERI,South Africa,ZAF,0,62,54,609,7,0,732,0,55,44,1240,11,0,1350,2082
2022,Estonia,EST,South Africa,ZAF,0,0,0,0,0,0,0,0,0,0,5,0,0,5,5
2022,Ethiopia,ETH,South Africa,ZAF,9,308,232,5158,10,0,5717,8,331,258,29425,77,0,30099,35816
2022,Gabon,GAB,South Africa,ZAF,0,0,0,5,0,0,5,0,0,0,0,0,0,0,5
2022,Gambia,GMB,South Africa,ZAF,0,0,0,0,0,0,0,0,0,0,5,0,0,5,5
2022,Palestinian,PSE,South Africa,ZAF,0,0,0,11,0,0,11,0,0,0,12,5,0,17,28
2022,Ghana,GHA,South Africa,ZAF,0,0,0,176,0,0,176,0,5,0,204,5,0,214,390
2022,Guinea-Bissau,GNB,South Africa,ZAF,0,0,0,0,0,0,0,0,0,0,7,0,0,7,7
2022,Guinea,GIN,South Africa,ZAF,0,0,0,5,0,0,5,0,0,0,17,0,0,17,22
2022,Cote d'Ivoire,CIV,South Africa,ZAF,0,0,0,32,0,0,32,0,0,0,73,0,0,73,105
2022,India,IND,South Africa,ZAF,0,0,7,236,6,0,249,0,7,6,1555,27,0,1595,1844
2022,Iraq,IRQ,South Africa,ZAF,0,5,0,0,0,0,5,0,0,0,7,0,0,7,12
2022,Jordan,JOR,South Africa,ZAF,0,0,0,0,0,0,0,0,0,0,12,0,0,12,12
2022,Kenya,KEN,South Africa,ZAF,0,5,11,254,0,0,270,0,5,8,335,12,0,360,630
2022,Liberia,LBR,South Africa,ZAF,0,0,5,16,0,0,21,0,0,0,38,5,0,43,64
2022,Lesotho,LSO,South Africa,ZAF,0,0,0,5,0,0,5,0,0,0,0,0,0,0,5
2022,Sri Lanka,LKA,South Africa,ZAF,0,0,0,0,0,0,0,0,0,0,16,0,0,16,16
2022,Mali,MLI,South Africa,ZAF,0,0,0,13,0,0,13,0,0,0,37,0,0,37,50
2022,Malawi,MWI,South Africa,ZAF,0,0,6,85,0,0,91,0,5,6,481,7,0,499,590
2022,Mozambique,MOZ,South Africa,ZAF,0,0,0,6,0,0,6,0,0,0,20,0,0,20,26
2022,Nepal,NPL,South Africa,ZAF,0,0,0,0,0,0,0,0,0,0,40,0,0,40,40
2022,Niger,NER,South Africa,ZAF,0,0,0,32,0,0,32,0,0,0,222,0,0,222,254
2022,Nigeria,NGA,South Africa,ZAF,0,9,16,313,0,0,338,0,5,15,1376,6,0,1402,1740
2022,Pakistan,PAK,South Africa,ZAF,0,5,0,94,0,0,99,0,0,8,3194,29,0,3231,3330
2022,Russian Federation,RUS,South Africa,ZAF,0,0,0,9,0,0,9,0,0,0,0,0,0,0,9
2022,Rwanda,RWA,South Africa,ZAF,0,45,75,574,21,0,715,0,50,79,794,32,0,955,1670
2022,Senegal,SEN,South Africa,ZAF,0,0,0,21,0,0,21,0,0,0,300,5,0,305,326
2022,Sierra Leone,SLE,South Africa,ZAF,0,0,0,0,0,0,0,0,0,0,15,5,0,20,20
2022,Solomon Islands,SLB,South Africa,ZAF,0,0,0,0,0,0,0,0,0,0,6,0,0,6,6
2022,Somalia,SOM,South Africa,ZAF,11,555,425,4077,54,0,5122,10,604,458,16907,254,0,18233,23355
2022,Sudan,SDN,South Africa,ZAF,0,0,5,17,0,0,22,0,0,0,83,5,0,88,110
2022,Eswatini,SWZ,South Africa,ZAF,0,0,0,0,0,0,0,0,0,0,6,0,0,6,6
2022,Syrian Arab Rep.,SYR,South Africa,ZAF,0,0,5,13,0,0,18,0,5,0,20,0,0,25,43
2022,United Rep. of Tanzania,TZA,South Africa,ZAF,0,5,5,41,0,0,51,0,6,0,206,0,0,212,263
2022,Thailand,THA,South Africa,ZAF,0,0,0,10,0,0,10,0,0,0,0,0,0,0,10
2022,Togo,TGO,South Africa,ZAF,0,0,0,5,0,0,5,0,0,7,12,0,0,19,24
2022,Türkiye,TUR,South Africa,ZAF,0,0,0,10,0,0,10,0,0,0,0,0,0,0,10
2022,Uganda,UGA,South Africa,ZAF,0,0,15,630,7,0,652,0,0,10,1929,27,0,1966,2618
2022,Yemen,YEM,South Africa,ZAF,0,0,0,5,0,0,5,0,0,0,0,0,0,0,5
2022,Zambia,ZMB,South Africa,ZAF,0,0,5,91,0,0,96,0,0,0,59,0,0,59,155
2022,Zimbabwe,ZWE,South Africa,ZAF,0,49,175,2489,66,0,2779,0,52,137,3607,95,0,3891,6670
2022,Afghanistan,AFG,Russian Federation,RUS,0,0,0,0,0,0,0,0,0,0,0,0,0,0,1589
2022,Egypt,EGY,Russian Federation,RUS,0,0,0,0,0,0,0,0,0,0,0,0,0,0,10
2022,Armenia,ARM,Russian Federation,RUS,0,0,0,0,0,0,0,0,0,0,0,0,0,0,35
2022,Azerbaijan,AZE,Russian Federation,RUS,0,0,0,0,0,0,0,0,0,0,0,0,0,0,48
2022,Bangladesh,BGD,Russian Federation,RUS,0,0,0,0,0,0,0,0,0,0,0,0,0,0,5
2022,Belarus,BLR,Russian Federation,RUS,0,0,0,0,0,0,0,0,0,0,0,0,0,0,10
2022,China,CHN,Russian Federation,RUS,0,0,0,0,0,0,0,0,0,0,0,0,0,0,19
2022,Dem. Rep. of the Congo,COD,Russian Federation,RUS,0,0,0,0,0,0,0,0,0,0,0,0,0,0,16
2022,Cuba,CUB,Russian Federation,RUS,0,0,0,0,0,0,0,0,0,0,0,0,0,0,5
2022,Estonia,EST,Russian Federation,RUS,0,0,0,0,0,0,0,0,0,0,0,0,0,0,5
2022,Palestinian,PSE,Russian Federation,RUS,0,0,0,0,0,0,0,0,0,0,0,0,0,0,5
2022,Georgia,GEO,Russian Federation,RUS,0,0,0,0,0,0,0,0,0,0,0,0,0,0,123
2022,Germany,DEU,Russian Federation,RUS,0,0,0,0,0,0,0,0,0,0,0,0,0,0,54
2022,Guinea,GIN,Russian Federation,RUS,0,0,0,0,0,0,0,0,0,0,0,0,0,0,5
2022,Iran (Islamic Rep. of),IRN,Russian Federation,RUS,0,0,0,0,0,0,0,0,0,0,0,0,0,0,5
2022,Iraq,IRQ,Russian Federation,RUS,0,0,0,0,0,0,0,0,0,0,0,0,0,0,14
2022,Israel,ISR,Russian Federation,RUS,0,0,0,0,0,0,0,0,0,0,0,0,0,0,5
2022,Kazakhstan,KAZ,Russian Federation,RUS,0,0,0,0,0,0,0,0,0,0,0,0,0,0,48
2022,Kyrgyzstan,KGZ,Russian Federation,RUS,0,0,0,0,0,0,0,0,0,0,0,0,0,0,38
2022,Rep. of Korea,KOR,Russian Federation,RUS,0,0,0,0,0,0,0,0,0,0,0,0,0,0,5
2022,Dem. People's Rep. of Korea,PRK,Russian Federation,RUS,0,0,0,0,0,0,0,0,0,0,0,0,0,0,37
2022,Libya,LBY,Russian Federation,RUS,0,0,0,0,0,0,0,0,0,0,0,0,0,0,5
2022,Lebanon,LBN,Russian Federation,RUS,0,0,0,0,0,0,0,0,0,0,0,0,0,0,5
2022,Lithuania,LTU,Russian Federation,RUS,0,0,0,0,0,0,0,0,0,0,0,0,0,0,8
2022,Latvia,LVA,Russian Federation,RUS,0,0,0,0,0,0,0,0,0,0,0,0,0,0,15
2022,Rep. of Moldova,MDA,Russian Federation,RUS,0,0,0,0,0,0,0,0,0,0,0,0,0,0,34
2022,Nigeria,NGA,Russian Federation,RUS,0,0,0,0,0,0,0,0,0,0,0,0,0,0,5
2022,Pakistan,PAK,Russian Federation,RUS,0,0,0,0,0,0,0,0,0,0,0,0,0,0,5
2022,Philippines,PHL,Russian Federation,RUS,0,0,0,0,0,0,0,0,0,0,0,0,0,0,5
2022,Poland,POL,Russian Federation,RUS,0,0,0,0,0,0,0,0,0,0,0,0,0,0,5
2022,Serbia and Kosovo: S/RES/1244 (1999),SRB,Russian Federation,RUS,0,0,0,0,0,0,0,0,0,0,0,0,0,0,5
2022,Viet Nam,VNM,Russian Federation,RUS,0,0,0,0,0,0,0,0,0,0,0,0,0,0,5
2022,Stateless,XXA,Russian Federation,RUS,0,0,0,0,0,0,0,0,0,0,0,0,0,0,34
2022,Sudan,SDN,Russian Federation,RUS,0,0,0,0,0,0,0,0,0,0,0,0,0,0,5
2022,Syrian Arab Rep.,SYR,Russian Federation,RUS,0,0,0,0,0,0,0,0,0,0,0,0,0,0,252
2022,Tajikistan,TJK,Russian Federation,RUS,0,0,0,0,0,0,0,0,0,0,0,0,0,0,49
2022,Turkmenistan,TKM,Russian Federation,RUS,0,0,0,0,0,0,0,0,0,0,0,0,0,0,84
2022,Türkiye,TUR,Russian Federation,RUS,0,0,0,0,0,0,0,0,0,0,0,0,0,0,6
2022,Unknown ,UNK,Russian Federation,RUS,0,0,0,0,0,0,0,0,0,0,0,0,0,0,12
2022,Ukraine,UKR,Russian Federation,RUS,0,0,0,0,0,0,0,0,0,0,0,0,0,0,1275925
2022,United States of America,USA,Russian Federation,RUS,0,0,0,0,0,0,0,0,0,0,0,0,0,0,14
2022,Uzbekistan,UZB,Russian Federation,RUS,0,0,0,0,0,0,0,0,0,0,0,0,0,0,88
2022,Yemen,YEM,Russian Federation,RUS,0,0,0,0,0,0,0,0,0,0,0,0,0,0,91
2022,Angola,AGO,Rwanda,RWA,0,0,0,9,0,0,9,0,0,0,0,0,0,0,9
2022,Burundi,BDI,Rwanda,RWA,3753,4016,2682,10357,727,0,21535,3714,4248,2803,14583,696,0,26044,48420
2022,Chad,TCD,Rwanda,RWA,0,0,0,0,0,0,0,0,0,0,6,0,0,6,6
2022,Cameroon,CMR,Rwanda,RWA,0,0,0,0,0,0,0,0,0,0,7,0,0,7,7
2022,Dem. Rep. of the Congo,COD,Rwanda,RWA,4475,6866,5997,19926,2101,0,39365,4518,6957,5942,13793,1545,0,32755,72120
2022,Eritrea,ERI,Rwanda,RWA,11,0,22,113,0,0,146,21,0,7,167,0,0,195,341
2022,Ethiopia,ETH,Rwanda,RWA,0,0,5,28,0,0,33,0,0,0,15,0,0,15,48
2022,Guinea,GIN,Rwanda,RWA,0,5,0,0,0,0,5,0,0,0,0,0,0,0,5
2022,Somalia,SOM,Rwanda,RWA,0,0,5,5,0,0,10,7,0,9,10,0,0,26,36
2022,South Sudan,SSD,Rwanda,RWA,0,6,0,0,0,0,6,0,5,0,12,0,0,17,23
2022,Sudan,SDN,Rwanda,RWA,17,0,0,38,0,0,55,11,12,20,108,0,0,151,206
2022,Syrian Arab Rep.,SYR,Rwanda,RWA,0,5,0,0,0,0,5,0,0,0,0,0,0,0,5
2022,Yemen,YEM,Rwanda,RWA,0,0,0,0,0,0,0,0,0,5,0,0,0,5,5
2022,Colombia,COL,El Salvador,SLV,0,0,0,15,0,0,15,0,9,0,0,0,0,9,24
2022,Cuba,CUB,El Salvador,SLV,0,0,0,0,0,0,0,0,0,0,5,0,0,5,5
2022,Guatemala,GTM,El Salvador,SLV,6,0,0,0,0,0,6,0,0,0,5,0,0,5,11
2022,Honduras,HND,El Salvador,SLV,0,5,0,14,0,0,19,0,0,9,8,0,0,17,36
2022,Iraq,IRQ,El Salvador,SLV,0,0,0,0,0,0,0,0,0,0,5,0,0,5,5
2022,Nicaragua,NIC,El Salvador,SLV,0,0,0,17,0,0,17,0,5,0,27,0,0,32,49
2022,United States of America,USA,El Salvador,SLV,0,0,5,0,0,0,5,0,5,0,0,0,0,5,10
2022,Venezuela (Bolivarian Republic of),VEN,El Salvador,SLV,0,0,5,0,0,0,5,0,0,0,13,0,0,13,18
2022,Chad,TCD,Saudi Arabia,SAU,0,0,0,9,0,0,9,0,0,0,0,0,0,0,9
2022,China,CHN,Saudi Arabia,SAU,0,0,6,17,0,0,23,0,0,0,5,0,0,5,28
2022,Eritrea,ERI,Saudi Arabia,SAU,0,0,0,22,0,0,22,0,0,6,16,7,0,29,51
2022,Palestinian,PSE,Saudi Arabia,SAU,0,5,0,12,0,0,17,0,6,0,18,0,0,24,41
2022,Iraq,IRQ,Saudi Arabia,SAU,0,0,5,18,0,0,23,0,0,5,26,5,0,36,59
2022,Liberia,LBR,Saudi Arabia,SAU,0,0,0,9,0,0,9,0,0,0,0,0,0,0,9
2022,Somalia,SOM,Saudi Arabia,SAU,0,0,9,9,0,0,18,0,0,0,7,0,0,7,25
2022,Sudan,SDN,Saudi Arabia,SAU,0,0,5,0,0,0,5,0,0,0,0,0,0,0,5
2022,Syrian Arab Rep.,SYR,Saudi Arabia,SAU,88,475,345,929,72,0,1909,110,535,357,950,85,0,2037,3946
2022,Tunisia,TUN,Saudi Arabia,SAU,0,0,0,6,0,0,6,0,0,0,0,0,0,0,6
2022,Yemen,YEM,Saudi Arabia,SAU,0,21,17,62,0,0,100,6,21,15,74,0,0,116,216
2022,Burundi,BDI,Senegal,SEN,0,0,0,0,0,0,0,0,0,5,0,0,0,5,5
2022,Burkina Faso,BFA,Senegal,SEN,5,0,0,0,0,0,5,0,0,0,0,0,0,0,5
2022,Central African Rep.,CAF,Senegal,SEN,16,26,26,112,5,0,185,14,30,17,130,0,0,191,376
2022,Chad,TCD,Senegal,SEN,0,6,0,0,0,0,6,0,0,0,10,0,0,10,16
2022,Congo,COG,Senegal,SEN,0,0,0,0,0,0,0,0,0,0,9,0,0,9,9
2022,Dem. Rep. of the Congo,COD,Senegal,SEN,0,0,7,5,0,0,12,0,0,0,8,0,0,8,20
2022,Comoros,COM,Senegal,SEN,0,0,0,5,0,0,5,0,0,0,5,0,0,5,10
2022,Gambia,GMB,Senegal,SEN,0,0,0,7,0,0,7,0,0,0,48,0,0,48,55
2022,Guinea,GIN,Senegal,SEN,0,0,7,0,0,0,7,0,0,6,8,0,0,14,21
2022,Cote d'Ivoire,CIV,Senegal,SEN,0,0,0,5,0,0,5,0,0,0,0,0,0,0,5
2022,Liberia,LBR,Senegal,SEN,0,0,0,0,0,0,0,0,0,0,5,0,0,5,5
2022,Mauritania,MRT,Senegal,SEN,515,1164,1123,3039,466,0,6307,542,1167,946,2127,412,0,5194,11501
2022,Mali,MLI,Senegal,SEN,0,0,0,0,0,0,0,0,0,0,5,0,0,5,5
2022,Nigeria,NGA,Senegal,SEN,0,0,0,0,0,0,0,0,0,0,5,0,0,5,5
2022,Rwanda,RWA,Senegal,SEN,0,5,0,0,0,0,5,0,0,0,0,0,0,0,5
2022,Sierra Leone,SLE,Senegal,SEN,0,0,0,0,0,0,0,0,0,0,6,0,0,6,6
2022,Togo,TGO,Senegal,SEN,0,8,0,0,0,0,8,0,0,0,0,0,0,0,8
2022,Türkiye,TUR,Senegal,SEN,0,0,0,0,0,0,0,0,5,0,0,0,0,5,5
2022,Egypt,EGY,Somalia,SOM,0,0,0,0,0,0,0,0,0,0,5,0,0,5,5
2022,Bangladesh,BGD,Somalia,SOM,0,0,0,0,0,0,0,0,6,0,0,0,0,6,6
2022,Cameroon,CMR,Somalia,SOM,0,0,0,0,0,0,0,0,0,0,5,0,0,5,5
2022,Djibouti,DJI,Somalia,SOM,0,0,0,7,0,0,7,0,0,0,0,0,0,0,7
2022,Eritrea,ERI,Somalia,SOM,5,0,15,22,0,0,42,0,11,6,29,10,0,56,98
2022,Ethiopia,ETH,Somalia,SOM,1735,2683,1873,5227,144,0,11662,1887,2747,1877,4776,244,0,11531,23193
2022,Palestinian,PSE,Somalia,SOM,0,0,0,0,0,0,0,0,0,0,8,0,0,8,8
2022,Iraq,IRQ,Somalia,SOM,0,0,0,0,0,0,0,0,0,0,5,0,0,5,5
2022,Jordan,JOR,Somalia,SOM,0,0,0,5,0,0,5,0,0,0,0,0,0,0,5
2022,Lebanon,LBN,Somalia,SOM,0,0,0,0,0,0,0,0,0,5,0,0,0,5,5
2022,Mozambique,MOZ,Somalia,SOM,0,0,0,0,0,0,0,0,0,5,0,0,0,5,5
2022,Sudan,SDN,Somalia,SOM,0,0,0,5,0,0,5,0,0,6,0,0,0,6,11
2022,Syrian Arab Rep.,SYR,Somalia,SOM,90,87,56,261,7,0,501,74,104,73,472,8,0,731,1232
2022,United Rep. of Tanzania,TZA,Somalia,SOM,17,26,10,6,0,0,59,19,27,11,23,0,0,80,139
2022,Yemen,YEM,Somalia,SOM,320,606,524,1728,164,0,3342,348,644,662,4607,274,0,6535,9877
2022,Afghanistan,AFG,Spain,ESP,0,0,0,0,0,568,568,0,0,0,0,0,642,642,3903
2022,Albania,ALB,Spain,ESP,0,0,0,0,0,40,40,0,0,0,0,0,60,60,113
2022,Algeria,DZA,Spain,ESP,0,0,0,0,0,222,222,0,0,0,0,0,793,793,1203
2022,Angola,AGO,Spain,ESP,0,0,0,0,0,15,15,0,0,0,0,0,15,15,68
2022,Egypt,EGY,Spain,ESP,0,0,0,0,0,16,16,0,0,0,0,0,184,184,321
2022,Argentina,ARG,Spain,ESP,0,0,0,0,0,368,368,0,0,0,0,0,402,402,825
2022,Armenia,ARM,Spain,ESP,0,0,0,0,0,135,135,0,0,0,0,0,180,180,474
2022,Azerbaijan,AZE,Spain,ESP,0,0,0,0,0,12,12,0,0,0,0,0,18,18,111
2022,Burundi,BDI,Spain,ESP,0,0,0,0,0,0,0,0,0,0,0,0,0,0,9
2022,Benin,BEN,Spain,ESP,0,0,0,0,0,0,0,0,0,0,0,0,0,0,15
2022,Bangladesh,BGD,Spain,ESP,0,0,0,0,0,5,5,0,0,0,0,0,225,225,259
2022,Burkina Faso,BFA,Spain,ESP,0,0,0,0,0,5,5,0,0,0,0,0,155,155,407
2022,Belarus,BLR,Spain,ESP,0,0,0,0,0,130,130,0,0,0,0,0,145,145,554
2022,Bolivia (Plurinational State of),BOL,Spain,ESP,0,0,0,0,0,53,53,0,0,0,0,0,52,52,118
2022,Brazil,BRA,Spain,ESP,0,0,0,0,0,398,398,0,0,0,0,0,392,392,866
2022,Bosnia and Herzegovina,BIH,Spain,ESP,0,0,0,0,0,0,0,0,0,0,0,0,0,0,5
2022,Canada,CAN,Spain,ESP,0,0,0,0,0,0,0,0,0,0,0,0,0,0,21
2022,Central African Rep.,CAF,Spain,ESP,0,0,0,0,0,10,10,0,0,0,0,0,25,25,185
2022,Chad,TCD,Spain,ESP,0,0,0,0,0,0,0,0,0,0,0,0,0,0,57
2022,China,CHN,Spain,ESP,0,0,0,0,0,265,265,0,0,0,0,0,120,120,500
2022,Chile,CHL,Spain,ESP,0,0,0,0,0,140,140,0,0,0,0,0,125,125,332
2022,Cameroon,CMR,Spain,ESP,0,0,0,0,0,155,155,0,0,0,0,0,295,295,612
2022,Congo,COG,Spain,ESP,0,0,0,0,0,25,25,0,0,0,0,0,20,20,113
2022,Dem. Rep. of the Congo,COD,Spain,ESP,0,0,0,0,0,40,40,0,0,0,0,0,55,55,189
2022,Comoros,COM,Spain,ESP,0,0,0,0,0,0,0,0,0,0,0,0,0,0,5
2022,Colombia,COL,Spain,ESP,0,0,0,0,0,20280,20280,0,0,0,0,0,20065,20065,43354
2022,Costa Rica,CRI,Spain,ESP,0,0,0,0,0,45,45,0,0,0,0,0,40,40,90
2022,Cuba,CUB,Spain,ESP,0,0,0,0,0,1420,1420,0,0,0,0,0,1980,1980,3604
2022,Djibouti,DJI,Spain,ESP,0,0,0,0,0,0,0,0,0,0,0,0,0,0,5
2022,Dominican Rep.,DOM,Spain,ESP,0,0,0,0,0,45,45,0,0,0,0,0,45,45,120
2022,Ecuador,ECU,Spain,ESP,0,0,0,0,0,330,330,0,0,0,0,0,395,395,803
2022,Equatorial Guinea,GNQ,Spain,ESP,0,0,0,0,0,30,30,0,0,0,0,0,35,35,119
2022,Eritrea,ERI,Spain,ESP,0,0,0,0,0,15,15,0,0,0,0,0,35,35,410
2022,Ethiopia,ETH,Spain,ESP,0,0,0,0,0,10,10,0,0,0,0,0,20,20,51
2022,France,FRA,Spain,ESP,0,0,0,0,0,0,0,0,0,0,0,0,0,0,5
2022,Gabon,GAB,Spain,ESP,0,0,0,0,0,5,5,0,0,0,0,0,0,0,10
2022,Gambia,GMB,Spain,ESP,0,0,0,0,0,35,35,0,0,0,0,0,375,375,486
2022,Palestinian,PSE,Spain,ESP,0,0,0,0,0,135,135,0,0,0,0,0,235,235,1696
2022,United Kingdom of Great Britain and Northern Ireland,GBR,Spain,ESP,0,0,0,0,0,0,0,0,0,0,0,0,0,0,21
2022,Georgia,GEO,Spain,ESP,0,0,0,0,0,675,675,0,0,0,0,0,900,900,1825
2022,Ghana,GHA,Spain,ESP,0,0,0,0,0,30,30,0,0,0,0,0,125,125,184
2022,Guinea-Bissau,GNB,Spain,ESP,0,0,0,0,0,10,10,0,0,0,0,0,50,50,71
2022,Guatemala,GTM,Spain,ESP,0,0,0,0,0,240,240,0,0,0,0,0,250,250,664
2022,Guinea,GIN,Spain,ESP,0,0,0,0,0,45,45,0,0,0,0,0,625,625,938
2022,Haiti,HTI,Spain,ESP,0,0,0,0,0,75,75,0,0,0,0,0,110,110,191
2022,Honduras,HND,Spain,ESP,0,0,0,0,0,2878,2878,0,0,0,0,0,3242,3242,8286
2022,Cote d'Ivoire,CIV,Spain,ESP,0,0,0,0,0,195,195,0,0,0,0,0,570,570,1119
2022,India,IND,Spain,ESP,0,0,0,0,0,12,12,0,0,0,0,0,33,33,133
2022,Indonesia,IDN,Spain,ESP,0,0,0,0,0,5,5,0,0,0,0,0,0,0,5
2022,Iran (Islamic Rep. of),IRN,Spain,ESP,0,0,0,0,0,32,32,0,0,0,0,0,68,68,264
2022,Iraq,IRQ,Spain,ESP,0,0,0,0,0,15,15,0,0,0,0,0,50,50,371
2022,Israel,ISR,Spain,ESP,0,0,0,0,0,0,0,0,0,0,0,0,0,0,51
2022,Jamaica,JAM,Spain,ESP,0,0,0,0,0,5,5,0,0,0,0,0,10,10,82
2022,Jordan,JOR,Spain,ESP,0,0,0,0,0,10,10,0,0,0,0,0,10,10,45
2022,Kazakhstan,KAZ,Spain,ESP,0,0,0,0,0,28,28,0,0,0,0,0,22,22,104
2022,Kenya,KEN,Spain,ESP,0,0,0,0,0,5,5,0,0,0,0,0,0,0,20
2022,Kyrgyzstan,KGZ,Spain,ESP,0,0,0,0,0,10,10,0,0,0,0,0,10,10,33
2022,Rep. of Korea,KOR,Spain,ESP,0,0,0,0,0,0,0,0,0,0,0,0,0,0,5
2022,Kuwait,KWT,Spain,ESP,0,0,0,0,0,0,0,0,0,0,0,0,0,0,10
2022,Liberia,LBR,Spain,ESP,0,0,0,0,0,10,10,0,0,0,0,0,25,25,42
2022,Libya,LBY,Spain,ESP,0,0,0,0,0,12,12,0,0,0,0,0,23,23,207
2022,Lebanon,LBN,Spain,ESP,0,0,0,0,0,10,10,0,0,0,0,0,15,15,63
2022,Sri Lanka,LKA,Spain,ESP,0,0,0,0,0,0,0,0,0,0,0,0,0,0,62
2022,Mauritania,MRT,Spain,ESP,0,0,0,0,0,10,10,0,0,0,0,0,110,110,153
2022,North Macedonia,MKD,Spain,ESP,0,0,0,0,0,10,10,0,0,0,0,0,10,10,20
2022,Rep. of Moldova,MDA,Spain,ESP,0,0,0,0,0,35,35,0,0,0,0,0,80,80,252
2022,Mexico,MEX,Spain,ESP,0,0,0,0,0,95,95,0,0,0,0,0,130,130,289
2022,Mali,MLI,Spain,ESP,0,0,0,0,0,65,65,0,0,0,0,0,2385,2385,8790
2022,Mongolia,MNG,Spain,ESP,0,0,0,0,0,0,0,0,0,0,0,0,0,0,17
2022,Morocco,MAR,Spain,ESP,0,0,0,0,0,1340,1340,0,0,0,0,0,4585,4585,7023
2022,Mozambique,MOZ,Spain,ESP,0,0,0,0,0,0,0,0,0,0,0,0,0,0,5
2022,Myanmar,MMR,Spain,ESP,0,0,0,0,0,0,0,0,0,0,0,0,0,0,13
2022,Nepal,NPL,Spain,ESP,0,0,0,0,0,0,0,0,0,0,0,0,0,0,5
2022,Netherlands (Kingdom of the),NLD,Spain,ESP,0,0,0,0,0,0,0,0,0,0,0,0,0,0,5
2022,Niger,NER,Spain,ESP,0,0,0,0,0,0,0,0,0,0,0,0,0,0,31
2022,Nicaragua,NIC,Spain,ESP,0,0,0,0,0,2153,2153,0,0,0,0,0,2707,2707,7119
2022,Nigeria,NGA,Spain,ESP,0,0,0,0,0,410,410,0,0,0,0,0,560,560,1291
2022,Pakistan,PAK,Spain,ESP,0,0,0,0,0,65,65,0,0,0,0,0,605,605,1130
2022,Panama,PAN,Spain,ESP,0,0,0,0,0,53,53,0,0,0,0,0,67,67,174
2022,Paraguay,PRY,Spain,ESP,0,0,0,0,0,375,375,0,0,0,0,0,450,450,915
2022,Peru,PER,Spain,ESP,0,0,0,0,0,5325,5325,0,0,0,0,0,4830,4830,10547
2022,Philippines,PHL,Spain,ESP,0,0,0,0,0,5,5,0,0,0,0,0,10,10,26
2022,South Africa,ZAF,Spain,ESP,0,0,0,0,0,0,0,0,0,0,0,0,0,0,5
2022,Russian Federation,RUS,Spain,ESP,0,0,0,0,0,895,895,0,0,0,0,0,980,980,3630
2022,Rwanda,RWA,Spain,ESP,0,0,0,0,0,0,0,0,0,0,0,0,0,0,5
2022,El Salvador,SLV,Spain,ESP,0,0,0,0,0,1905,1905,0,0,0,0,0,1860,1860,5024
2022,Saudi Arabia,SAU,Spain,ESP,0,0,0,0,0,0,0,0,0,0,0,0,0,0,5
2022,Senegal,SEN,Spain,ESP,0,0,0,0,0,145,145,0,0,0,0,0,1735,1735,1964
2022,Sierra Leone,SLE,Spain,ESP,0,0,0,0,0,15,15,0,0,0,0,0,45,45,90
2022,Somalia,SOM,Spain,ESP,0,0,0,0,0,70,70,0,0,0,0,0,120,120,829
2022,Serbia and Kosovo: S/RES/1244 (1999),SRB,Spain,ESP,0,0,0,0,0,10,10,0,0,0,0,0,15,15,42
2022,Viet Nam,VNM,Spain,ESP,0,0,0,0,0,10,10,0,0,0,0,0,15,15,38
2022,South Sudan,SSD,Spain,ESP,0,0,0,0,0,0,0,0,0,0,0,0,0,0,15
2022,Stateless,XXA,Spain,ESP,0,0,0,0,0,5,5,0,0,0,0,0,5,5,16
2022,Sudan,SDN,Spain,ESP,0,0,0,0,0,10,10,0,0,0,0,0,180,180,1023
2022,Syrian Arab Rep.,SYR,Spain,ESP,0,0,0,0,0,275,275,0,0,0,0,0,365,365,16831
2022,Tibetan,TIB,Spain,ESP,0,0,0,0,0,0,0,0,0,0,0,0,0,0,5
2022,Tajikistan,TJK,Spain,ESP,0,0,0,0,0,0,0,0,0,0,0,0,0,0,16
2022,Turkmenistan,TKM,Spain,ESP,0,0,0,0,0,5,5,0,0,0,0,0,5,5,22
2022,Togo,TGO,Spain,ESP,0,0,0,0,0,0,0,0,0,0,0,0,0,0,20
2022,Trinidad and Tobago,TTO,Spain,ESP,0,0,0,0,0,5,5,0,0,0,0,0,5,5,16
2022,Tunisia,TUN,Spain,ESP,0,0,0,0,0,15,15,0,0,0,0,0,85,85,182
2022,Türkiye,TUR,Spain,ESP,0,0,0,0,0,50,50,0,0,0,0,0,230,230,515
2022,Uganda,UGA,Spain,ESP,0,0,0,0,0,0,0,0,0,0,0,0,0,0,13
2022,Unknown ,UNK,Spain,ESP,0,0,0,0,0,0,0,0,0,0,0,0,0,0,94
2022,Ukraine,UKR,Spain,ESP,0,0,0,0,0,101808,101808,0,0,0,0,0,58012,58012,162672
2022,Uruguay,URY,Spain,ESP,0,0,0,0,0,65,65,0,0,0,0,0,60,60,143
2022,United States of America,USA,Spain,ESP,0,0,0,0,0,20,20,0,0,0,0,0,35,35,187
2022,Uzbekistan,UZB,Spain,ESP,0,0,0,0,0,10,10,0,0,0,0,0,10,10,52
2022,Venezuela (Bolivarian Republic of),VEN,Spain,ESP,0,0,0,0,0,17740,17740,0,0,0,0,0,16650,16650,143484
2022,Western Sahara,ESH,Spain,ESP,0,0,0,0,0,0,0,0,0,0,0,0,0,0,15
2022,Yemen,YEM,Spain,ESP,0,0,0,0,0,35,35,0,0,0,0,0,205,205,759
2022,Afghanistan,AFG,Serbia and Kosovo: S/RES/1244 (1999),SRB,0,0,0,0,0,0,0,0,0,0,0,0,0,0,33
2022,Egypt,EGY,Serbia and Kosovo: S/RES/1244 (1999),SRB,0,0,0,0,0,0,0,0,0,0,0,0,0,0,5
2022,Armenia,ARM,Serbia and Kosovo: S/RES/1244 (1999),SRB,0,0,0,0,0,0,0,0,0,0,0,0,0,0,10
2022,Burundi,BDI,Serbia and Kosovo: S/RES/1244 (1999),SRB,0,0,0,0,0,0,0,0,0,0,0,0,0,0,55
2022,Bosnia and Herzegovina,BIH,Serbia and Kosovo: S/RES/1244 (1999),SRB,0,0,0,0,0,0,0,0,0,0,0,0,0,0,7879
2022,China,CHN,Serbia and Kosovo: S/RES/1244 (1999),SRB,0,0,0,0,0,0,0,0,0,0,0,0,0,0,5
2022,Cameroon,CMR,Serbia and Kosovo: S/RES/1244 (1999),SRB,0,0,0,0,0,0,0,0,0,0,0,0,0,0,5
2022,Congo,COG,Serbia and Kosovo: S/RES/1244 (1999),SRB,0,0,0,0,0,0,0,0,0,0,0,0,0,0,5
2022,Dem. Rep. of the Congo,COD,Serbia and Kosovo: S/RES/1244 (1999),SRB,0,0,0,0,0,0,0,0,0,0,0,0,0,0,7
2022,Cuba,CUB,Serbia and Kosovo: S/RES/1244 (1999),SRB,0,0,0,0,0,0,0,0,0,0,0,0,0,0,15
2022,Ethiopia,ETH,Serbia and Kosovo: S/RES/1244 (1999),SRB,0,0,0,0,0,0,0,0,0,0,0,0,0,0,5
2022,Palestinian,PSE,Serbia and Kosovo: S/RES/1244 (1999),SRB,0,0,0,0,0,0,0,0,0,0,5,0,0,5,5
2022,Guinea-Bissau,GNB,Serbia and Kosovo: S/RES/1244 (1999),SRB,0,0,0,0,0,0,0,0,0,0,0,0,0,0,5
2022,Croatia,HRV,Serbia and Kosovo: S/RES/1244 (1999),SRB,0,0,0,0,0,0,0,0,0,0,0,0,0,0,17169
2022,India,IND,Serbia and Kosovo: S/RES/1244 (1999),SRB,0,0,0,0,0,0,0,0,0,0,0,0,0,0,7
2022,Iran (Islamic Rep. of),IRN,Serbia and Kosovo: S/RES/1244 (1999),SRB,0,0,0,0,0,0,0,0,0,0,0,0,0,0,32
2022,Iraq,IRQ,Serbia and Kosovo: S/RES/1244 (1999),SRB,0,5,0,0,0,0,5,0,0,0,0,0,0,0,21
2022,Jordan,JOR,Serbia and Kosovo: S/RES/1244 (1999),SRB,0,8,0,0,0,0,8,0,0,0,0,0,0,0,8
2022,Libya,LBY,Serbia and Kosovo: S/RES/1244 (1999),SRB,0,0,0,0,0,0,0,0,0,0,0,0,0,0,47
2022,Morocco,MAR,Serbia and Kosovo: S/RES/1244 (1999),SRB,0,0,0,0,0,0,0,0,0,0,16,0,0,16,16
2022,Nigeria,NGA,Serbia and Kosovo: S/RES/1244 (1999),SRB,0,0,0,0,0,0,0,0,0,0,0,0,0,0,6
2022,Pakistan,PAK,Serbia and Kosovo: S/RES/1244 (1999),SRB,0,0,0,0,0,0,0,0,0,0,0,0,0,0,5
2022,South Africa,ZAF,Serbia and Kosovo: S/RES/1244 (1999),SRB,0,0,5,0,0,0,5,0,0,0,0,0,0,0,5
2022,Russian Federation,RUS,Serbia and Kosovo: S/RES/1244 (1999),SRB,0,0,0,0,0,0,0,0,0,0,0,0,0,0,44
2022,Somalia,SOM,Serbia and Kosovo: S/RES/1244 (1999),SRB,0,0,0,0,0,0,0,0,0,0,0,0,0,0,23
2022,Sudan,SDN,Serbia and Kosovo: S/RES/1244 (1999),SRB,0,0,0,0,0,0,0,0,0,0,0,0,0,0,5
2022,Syrian Arab Rep.,SYR,Serbia and Kosovo: S/RES/1244 (1999),SRB,0,0,0,0,0,0,0,0,0,0,5,0,0,5,47
2022,Türkiye,TUR,Serbia and Kosovo: S/RES/1244 (1999),SRB,10,11,13,36,0,0,70,6,17,10,26,0,0,59,129
2022,Ukraine,UKR,Serbia and Kosovo: S/RES/1244 (1999),SRB,0,0,0,11,0,0,11,5,0,0,0,0,0,5,1108
2022,Uzbekistan,UZB,Serbia and Kosovo: S/RES/1244 (1999),SRB,0,0,0,0,0,0,0,0,0,0,0,0,0,0,6
2022,Burundi,BDI,South Sudan,SSD,27,10,0,94,0,0,131,16,12,0,725,0,0,753,884
2022,Central African Rep.,CAF,South Sudan,SSD,106,239,238,570,31,0,1184,131,267,229,439,32,0,1098,2282
2022,Cameroon,CMR,South Sudan,SSD,0,0,0,0,0,5,5,0,0,0,0,0,0,0,5
2022,Dem. Rep. of the Congo,COD,South Sudan,SSD,1267,1257,759,1705,190,0,5178,1228,1228,747,1560,175,0,4938,10116
2022,Eritrea,ERI,South Sudan,SSD,106,81,5,417,5,0,614,122,106,8,1138,57,0,1431,2045
2022,Ethiopia,ETH,South Sudan,SSD,380,440,330,1182,79,0,2411,418,469,336,724,32,0,1979,4390
2022,Somalia,SOM,South Sudan,SSD,0,0,0,0,0,0,0,0,0,0,25,0,0,25,25
2022,Sudan,SDN,South Sudan,SSD,25348,35421,27018,60898,3942,0,152627,26569,37022,26498,44344,3699,0,138132,290759
2022,Andorra,AND,Sudan,SDN,0,0,5,0,0,0,5,0,0,0,0,0,0,0,5
2022,Egypt,EGY,Sudan,SDN,0,0,8,5,0,0,13,0,5,0,11,0,0,16,29
2022,Burundi,BDI,Sudan,SDN,0,0,0,6,0,0,6,0,0,0,15,0,0,15,21
2022,Central African Rep.,CAF,Sudan,SDN,1606,3599,2076,5663,663,0,13607,1725,3285,1866,3435,452,0,10763,24370
2022,Chad,TCD,Sudan,SDN,437,496,359,1049,133,0,2474,417,569,338,779,82,0,2185,4659
2022,Cameroon,CMR,Sudan,SDN,0,0,0,0,0,0,0,0,0,0,7,0,0,7,7
2022,Congo,COG,Sudan,SDN,0,0,0,7,0,0,7,0,5,0,5,5,0,15,22
2022,Dem. Rep. of the Congo,COD,Sudan,SDN,8,42,60,212,29,0,351,22,47,83,214,50,0,416,767
2022,Djibouti,DJI,Sudan,SDN,0,0,0,0,0,0,0,0,5,0,0,0,0,5,5
2022,Eritrea,ERI,Sudan,SDN,2287,9086,9362,41394,5821,0,67950,2327,9232,9513,39463,6229,0,66764,134714
2022,Ethiopia,ETH,Sudan,SDN,3704,4739,3513,17884,1319,0,31159,4099,5377,3905,24312,2125,0,39818,70977
2022,Palestinian,PSE,Sudan,SDN,0,5,7,17,0,0,29,0,0,5,39,0,0,44,73
2022,India,IND,Sudan,SDN,0,0,0,0,0,0,0,0,0,5,0,0,0,5,5
2022,Iraq,IRQ,Sudan,SDN,0,0,0,8,0,0,8,0,0,0,14,0,0,14,22
2022,Nigeria,NGA,Sudan,SDN,0,0,7,5,0,0,12,0,0,0,0,0,0,0,12
2022,Somalia,SOM,Sudan,SDN,16,28,35,137,0,0,216,5,33,23,340,5,0,406,622
2022,South Sudan,SSD,Sudan,SDN,49687,97193,63439,178480,22907,0,411706,50678,98232,64256,150829,21130,0,385125,796831
2022,Syrian Arab Rep.,SYR,Sudan,SDN,1550,8749,6341,23543,1531,0,41714,1588,10091,6837,31451,1797,0,51764,93478
2022,Türkiye,TUR,Sudan,SDN,0,0,5,0,0,0,5,0,0,0,0,0,0,0,5
2022,Uganda,UGA,Sudan,SDN,0,0,0,0,0,0,0,0,0,0,5,0,0,5,5
2022,Yemen,YEM,Sudan,SDN,20,90,90,448,32,0,680,20,114,96,1342,77,0,1649,2329
2022,Colombia,COL,Suriname,SUR,0,0,0,0,0,0,0,0,0,0,0,0,0,0,6
2022,Cuba,CUB,Suriname,SUR,0,0,0,0,0,0,0,0,0,0,0,0,0,0,2096
2022,Dominican Rep.,DOM,Suriname,SUR,0,0,0,0,0,0,0,0,0,0,0,0,0,0,10
2022,Guyana,GUY,Suriname,SUR,0,0,0,0,0,0,0,0,0,0,0,0,0,0,5
2022,Haiti,HTI,Suriname,SUR,0,0,0,0,0,0,0,0,0,0,0,0,0,0,6
2022,Nigeria,NGA,Suriname,SUR,0,0,0,0,0,0,0,0,0,0,0,0,0,0,5
2022,Venezuela (Bolivarian Republic of),VEN,Suriname,SUR,0,0,0,0,0,0,0,0,0,0,0,0,0,0,443
2022,Afghanistan,AFG,Slovakia,SVK,0,0,0,0,0,0,0,0,0,0,0,0,0,0,391
2022,Angola,AGO,Slovakia,SVK,0,0,0,0,0,0,0,0,0,0,0,0,0,0,24
2022,Egypt,EGY,Slovakia,SVK,0,0,0,0,0,0,0,0,0,0,0,0,0,0,17
2022,Armenia,ARM,Slovakia,SVK,0,0,0,0,0,0,0,0,0,0,0,0,0,0,54
2022,Azerbaijan,AZE,Slovakia,SVK,0,0,0,0,0,0,0,0,0,0,0,0,0,0,25
2022,Burundi,BDI,Slovakia,SVK,0,0,0,0,0,0,0,0,0,0,0,0,0,0,5
2022,Belarus,BLR,Slovakia,SVK,0,0,0,0,0,0,0,0,0,0,0,0,0,0,45
2022,Bosnia and Herzegovina,BIH,Slovakia,SVK,0,0,0,0,0,0,0,0,0,0,0,0,0,0,36
2022,Bulgaria,BGR,Slovakia,SVK,0,0,0,0,0,0,0,0,0,0,0,0,0,0,8
2022,Cambodia,KHM,Slovakia,SVK,0,0,0,0,0,0,0,0,0,0,0,0,0,0,5
2022,China,CHN,Slovakia,SVK,0,0,0,0,0,0,0,0,0,0,0,0,0,0,15
2022,Cameroon,CMR,Slovakia,SVK,0,0,0,0,0,0,0,0,0,0,0,0,0,0,10
2022,Dem. Rep. of the Congo,COD,Slovakia,SVK,0,0,0,0,0,0,0,0,0,0,0,0,0,0,16
2022,Cuba,CUB,Slovakia,SVK,0,0,0,0,0,0,0,0,0,0,0,0,0,0,32
2022,Palestinian,PSE,Slovakia,SVK,0,0,0,0,0,0,0,0,0,0,0,0,0,0,7
2022,Georgia,GEO,Slovakia,SVK,0,0,0,0,0,0,0,0,0,0,0,0,0,0,14
2022,India,IND,Slovakia,SVK,0,0,0,0,0,0,0,0,0,0,0,0,0,0,12
2022,Iran (Islamic Rep. of),IRN,Slovakia,SVK,0,0,0,0,0,0,0,0,0,0,0,0,0,0,44
2022,Iraq,IRQ,Slovakia,SVK,0,0,0,0,0,0,0,0,0,0,0,0,0,0,221
2022,Israel,ISR,Slovakia,SVK,0,0,0,0,0,0,0,0,0,0,0,0,0,0,8
2022,Kazakhstan,KAZ,Slovakia,SVK,0,0,0,0,0,0,0,0,0,0,0,0,0,0,11
2022,Kyrgyzstan,KGZ,Slovakia,SVK,0,0,0,0,0,0,0,0,0,0,0,0,0,0,5
2022,Liberia,LBR,Slovakia,SVK,0,0,0,0,0,0,0,0,0,0,0,0,0,0,5
2022,Libya,LBY,Slovakia,SVK,0,0,0,0,0,0,0,0,0,0,0,0,0,0,16
2022,Sri Lanka,LKA,Slovakia,SVK,0,0,0,0,0,0,0,0,0,0,0,0,0,0,5
2022,Rep. of Moldova,MDA,Slovakia,SVK,0,0,0,0,0,0,0,0,0,0,0,0,0,0,22
2022,Morocco,MAR,Slovakia,SVK,0,0,0,0,0,0,0,0,0,0,0,0,0,0,5
2022,Nigeria,NGA,Slovakia,SVK,0,0,0,0,0,0,0,0,0,0,0,0,0,0,19
2022,Pakistan,PAK,Slovakia,SVK,0,0,0,0,0,0,0,0,0,0,0,0,0,0,18
2022,Romania,ROU,Slovakia,SVK,0,0,0,0,0,0,0,0,0,0,0,0,0,0,37
2022,Russian Federation,RUS,Slovakia,SVK,0,0,0,0,0,0,0,0,0,0,0,0,0,0,326
2022,Somalia,SOM,Slovakia,SVK,0,0,0,0,0,0,0,0,0,0,0,0,0,0,34
2022,Serbia and Kosovo: S/RES/1244 (1999),SRB,Slovakia,SVK,0,0,0,0,0,0,0,0,0,0,0,0,0,0,47
2022,Viet Nam,VNM,Slovakia,SVK,0,0,0,0,0,0,0,0,0,0,0,0,0,0,25
2022,Stateless,XXA,Slovakia,SVK,0,0,0,0,0,0,0,0,0,0,0,0,0,0,9
2022,Syrian Arab Rep.,SYR,Slovakia,SVK,0,0,0,0,0,0,0,0,0,0,0,0,0,0,60
2022,Tunisia,TUN,Slovakia,SVK,0,0,0,0,0,0,0,0,0,0,0,0,0,0,5
2022,Türkiye,TUR,Slovakia,SVK,0,0,0,0,0,0,0,0,0,0,0,0,0,0,56
2022,Uganda,UGA,Slovakia,SVK,0,0,0,0,0,0,0,0,0,0,0,0,0,0,5
2022,Unknown ,UNK,Slovakia,SVK,0,0,0,0,0,0,0,0,0,0,0,0,0,0,54
2022,Ukraine,UKR,Slovakia,SVK,0,0,0,0,0,0,0,0,0,0,0,0,0,0,94858
2022,United States of America,USA,Slovakia,SVK,0,0,0,0,0,0,0,0,0,0,0,0,0,0,22
2022,Uzbekistan,UZB,Slovakia,SVK,0,0,0,0,0,0,0,0,0,0,0,0,0,0,9
2022,Yemen,YEM,Slovakia,SVK,0,0,0,0,0,0,0,0,0,0,0,0,0,0,25
2022,Afghanistan,AFG,Slovenia,SVN,0,0,0,0,0,0,0,0,0,0,0,0,21,21,88
2022,Algeria,DZA,Slovenia,SVN,0,0,0,0,0,0,0,0,0,0,0,0,14,14,14
2022,Azerbaijan,AZE,Slovenia,SVN,0,0,0,0,0,0,0,0,0,0,0,0,0,0,5
2022,Burundi,BDI,Slovenia,SVN,0,0,0,0,0,21,21,0,0,0,0,0,85,85,106
2022,Bangladesh,BGD,Slovenia,SVN,0,0,0,0,0,0,0,0,0,0,0,0,6,6,6
2022,Belarus,BLR,Slovenia,SVN,0,0,0,0,0,0,0,0,0,0,0,0,0,0,8
2022,Bosnia and Herzegovina,BIH,Slovenia,SVN,0,0,0,0,0,0,0,0,0,0,0,0,0,0,7
2022,China,CHN,Slovenia,SVN,0,0,0,0,0,0,0,0,0,0,0,0,5,5,5
2022,Cameroon,CMR,Slovenia,SVN,0,0,0,0,0,0,0,0,0,0,0,0,6,6,16
2022,Dem. Rep. of the Congo,COD,Slovenia,SVN,0,0,0,0,0,0,0,0,0,0,0,0,5,5,15
2022,Cuba,CUB,Slovenia,SVN,0,0,0,0,0,10,10,0,0,0,0,0,33,33,43
2022,Eritrea,ERI,Slovenia,SVN,0,0,0,0,0,0,0,0,0,0,0,0,0,0,86
2022,Gambia,GMB,Slovenia,SVN,0,0,0,0,0,0,0,0,0,0,0,0,6,6,6
2022,Palestinian,PSE,Slovenia,SVN,0,0,0,0,0,5,5,0,0,0,0,0,0,0,32
2022,Ghana,GHA,Slovenia,SVN,0,0,0,0,0,0,0,0,0,0,0,0,5,5,5
2022,India,IND,Slovenia,SVN,0,0,0,0,0,0,0,0,0,0,0,0,47,47,47
2022,Iran (Islamic Rep. of),IRN,Slovenia,SVN,0,0,0,0,0,5,5,0,0,0,0,0,7,7,98
2022,Iraq,IRQ,Slovenia,SVN,0,0,0,0,0,0,0,0,0,0,0,0,6,6,59
2022,Kazakhstan,KAZ,Slovenia,SVN,0,0,0,0,0,0,0,0,0,0,0,0,0,0,21
2022,Libya,LBY,Slovenia,SVN,0,0,0,0,0,5,5,0,0,0,0,0,0,0,5
2022,Sri Lanka,LKA,Slovenia,SVN,0,0,0,0,0,0,0,0,0,0,0,0,5,5,5
2022,Morocco,MAR,Slovenia,SVN,0,0,0,0,0,0,0,0,0,0,0,0,74,74,79
2022,Nepal,NPL,Slovenia,SVN,0,0,0,0,0,0,0,0,0,0,0,0,5,5,5
2022,Nigeria,NGA,Slovenia,SVN,0,0,0,0,0,0,0,0,0,0,0,0,5,5,11
2022,Pakistan,PAK,Slovenia,SVN,0,0,0,0,0,0,0,0,0,0,0,0,14,14,19
2022,Russian Federation,RUS,Slovenia,SVN,0,0,0,0,0,27,27,0,0,0,0,0,39,39,116
2022,Somalia,SOM,Slovenia,SVN,0,0,0,0,0,0,0,0,0,0,0,0,0,0,52
2022,Serbia and Kosovo: S/RES/1244 (1999),SRB,Slovenia,SVN,0,0,0,0,0,0,0,0,0,0,0,0,0,0,11
2022,Stateless,XXA,Slovenia,SVN,0,0,0,0,0,0,0,0,0,0,0,0,0,0,12
2022,Sudan,SDN,Slovenia,SVN,0,0,0,0,0,0,0,0,0,0,0,0,0,0,6
2022,Syrian Arab Rep.,SYR,Slovenia,SVN,0,0,0,0,0,0,0,0,0,0,0,0,0,0,340
2022,Tunisia,TUN,Slovenia,SVN,0,0,0,0,0,0,0,0,0,0,0,0,10,10,10
2022,Türkiye,TUR,Slovenia,SVN,0,0,0,0,0,0,0,0,0,0,0,0,8,8,68
2022,Unknown ,UNK,Slovenia,SVN,0,0,0,0,0,0,0,0,0,0,0,0,5,5,16
2022,Ukraine,UKR,Slovenia,SVN,0,0,0,0,0,5088,5088,0,0,0,0,0,2515,2515,7764
2022,United States of America,USA,Slovenia,SVN,0,0,0,0,0,8,8,0,0,0,0,0,0,0,8
2022,Yemen,YEM,Slovenia,SVN,0,0,0,0,0,0,0,0,0,0,0,0,0,0,6
2022,Angola,AGO,Eswatini,SWZ,0,6,0,0,0,0,6,0,0,0,6,0,0,6,12
2022,Burundi,BDI,Eswatini,SWZ,5,34,26,77,0,0,142,0,15,29,96,5,0,145,287
2022,Cameroon,CMR,Eswatini,SWZ,0,0,0,6,0,0,6,0,0,0,15,0,0,15,21
2022,Congo,COG,Eswatini,SWZ,0,0,5,12,0,0,17,0,0,9,15,0,0,24,41
2022,Dem. Rep. of the Congo,COD,Eswatini,SWZ,38,70,52,201,5,0,366,28,58,25,231,7,0,349,715
2022,Eritrea,ERI,Eswatini,SWZ,0,0,0,5,0,0,5,0,0,0,39,0,0,39,44
2022,Ethiopia,ETH,Eswatini,SWZ,0,5,7,21,0,0,33,0,7,5,105,0,0,117,150
2022,Nigeria,NGA,Eswatini,SWZ,0,6,0,0,0,0,6,0,0,0,0,0,0,0,6
2022,Rwanda,RWA,Eswatini,SWZ,5,19,18,74,0,0,116,8,13,24,99,6,0,150,266
2022,Somalia,SOM,Eswatini,SWZ,5,0,10,23,0,0,38,9,5,0,535,0,0,549,587
2022,United Rep. of Tanzania,TZA,Eswatini,SWZ,0,0,0,0,0,0,0,0,0,0,5,0,0,5,5
2022,Uganda,UGA,Eswatini,SWZ,0,0,0,6,0,0,6,0,0,0,0,0,0,0,6
2022,Zimbabwe,ZWE,Eswatini,SWZ,0,0,0,0,0,0,0,0,0,0,9,0,0,9,9
2022,Afghanistan,AFG,Sweden,SWE,0,0,0,0,0,395,395,0,0,0,0,0,1657,1657,28249
2022,Albania,ALB,Sweden,SWE,0,0,0,0,0,53,53,0,0,0,0,0,81,81,363
2022,Algeria,DZA,Sweden,SWE,0,0,0,0,0,16,16,0,0,0,0,0,40,40,117
2022,Angola,AGO,Sweden,SWE,0,0,0,0,0,8,8,0,0,0,0,0,0,0,29
2022,Egypt,EGY,Sweden,SWE,0,0,0,0,0,42,42,0,0,0,0,0,86,86,536
2022,Argentina,ARG,Sweden,SWE,0,0,0,0,0,6,6,0,0,0,0,0,6,6,12
2022,Armenia,ARM,Sweden,SWE,0,0,0,0,0,73,73,0,0,0,0,0,77,77,483
2022,Azerbaijan,AZE,Sweden,SWE,0,0,0,0,0,55,55,0,0,0,0,0,135,135,835
2022,Bahrain,BHR,Sweden,SWE,0,0,0,0,0,5,5,0,0,0,0,0,0,0,21
2022,Burundi,BDI,Sweden,SWE,0,0,0,0,0,13,13,0,0,0,0,0,17,17,253
2022,Benin,BEN,Sweden,SWE,0,0,0,0,0,0,0,0,0,0,0,0,0,0,10
2022,Bangladesh,BGD,Sweden,SWE,0,0,0,0,0,39,39,0,0,0,0,0,63,63,337
2022,Burkina Faso,BFA,Sweden,SWE,0,0,0,0,0,0,0,0,0,0,0,0,0,0,5
2022,Belarus,BLR,Sweden,SWE,0,0,0,0,0,26,26,0,0,0,0,0,60,60,204
2022,Bolivia (Plurinational State of),BOL,Sweden,SWE,0,0,0,0,0,7,7,0,0,0,0,0,0,0,58
2022,Botswana,BWA,Sweden,SWE,0,0,0,0,0,8,8,0,0,0,0,0,0,0,8
2022,Brazil,BRA,Sweden,SWE,0,0,0,0,0,0,0,0,0,0,0,0,0,0,13
2022,Bosnia and Herzegovina,BIH,Sweden,SWE,0,0,0,0,0,20,20,0,0,0,0,0,28,28,107
2022,Bulgaria,BGR,Sweden,SWE,0,0,0,0,0,0,0,0,0,0,0,0,0,0,8
2022,Canada,CAN,Sweden,SWE,0,0,0,0,0,5,5,0,0,0,0,0,5,5,15
2022,Central African Rep.,CAF,Sweden,SWE,0,0,0,0,0,0,0,0,0,0,0,0,0,0,71
2022,Chad,TCD,Sweden,SWE,0,0,0,0,0,0,0,0,0,0,0,0,0,0,18
2022,China,CHN,Sweden,SWE,0,0,0,0,0,10,10,0,0,0,0,0,18,18,211
2022,Chile,CHL,Sweden,SWE,0,0,0,0,0,5,5,0,0,0,0,0,0,0,14
2022,Cameroon,CMR,Sweden,SWE,0,0,0,0,0,41,41,0,0,0,0,0,64,64,339
2022,Congo,COG,Sweden,SWE,0,0,0,0,0,11,11,0,0,0,0,0,15,15,58
2022,Dem. Rep. of the Congo,COD,Sweden,SWE,0,0,0,0,0,30,30,0,0,0,0,0,45,45,904
2022,Comoros,COM,Sweden,SWE,0,0,0,0,0,0,0,0,0,0,0,0,0,0,5
2022,Colombia,COL,Sweden,SWE,0,0,0,0,0,160,160,0,0,0,0,0,213,213,413
2022,Cuba,CUB,Sweden,SWE,0,0,0,0,0,11,11,0,0,0,0,0,11,11,46
2022,Djibouti,DJI,Sweden,SWE,0,0,0,0,0,5,5,0,0,0,0,0,5,5,42
2022,Ecuador,ECU,Sweden,SWE,0,0,0,0,0,0,0,0,0,0,0,0,0,0,11
2022,Equatorial Guinea,GNQ,Sweden,SWE,0,0,0,0,0,0,0,0,0,0,0,0,0,0,5
2022,Eritrea,ERI,Sweden,SWE,0,0,0,0,0,130,130,0,0,0,0,0,189,189,25621
2022,Ethiopia,ETH,Sweden,SWE,0,0,0,0,0,157,157,0,0,0,0,0,162,162,2853
2022,Gambia,GMB,Sweden,SWE,0,0,0,0,0,26,26,0,0,0,0,0,57,57,254
2022,Palestinian,PSE,Sweden,SWE,0,0,0,0,0,87,87,0,0,0,0,0,168,168,1607
2022,United Kingdom of Great Britain and Northern Ireland,GBR,Sweden,SWE,0,0,0,0,0,0,0,0,0,0,0,0,0,0,5
2022,Georgia,GEO,Sweden,SWE,0,0,0,0,0,23,23,0,0,0,0,0,54,54,206
2022,Ghana,GHA,Sweden,SWE,0,0,0,0,0,9,9,0,0,0,0,0,21,21,91
2022,Guinea-Bissau,GNB,Sweden,SWE,0,0,0,0,0,0,0,0,0,0,0,0,0,0,12
2022,Greece,GRC,Sweden,SWE,0,0,0,0,0,0,0,0,0,0,0,0,0,0,18
2022,Guatemala,GTM,Sweden,SWE,0,0,0,0,0,0,0,0,0,0,0,0,0,0,11
2022,Guinea,GIN,Sweden,SWE,0,0,0,0,0,5,5,0,0,0,0,0,7,7,69
2022,Haiti,HTI,Sweden,SWE,0,0,0,0,0,5,5,0,0,0,0,0,0,0,5
2022,Honduras,HND,Sweden,SWE,0,0,0,0,0,10,10,0,0,0,0,0,23,23,62
2022,Croatia,HRV,Sweden,SWE,0,0,0,0,0,5,5,0,0,0,0,0,0,0,5
2022,Hungary,HUN,Sweden,SWE,0,0,0,0,0,0,0,0,0,0,0,0,0,0,5
2022,Cote d'Ivoire,CIV,Sweden,SWE,0,0,0,0,0,0,0,0,0,0,0,0,0,0,29
2022,India,IND,Sweden,SWE,0,0,0,0,0,17,17,0,0,0,0,0,32,32,72
2022,Indonesia,IDN,Sweden,SWE,0,0,0,0,0,0,0,0,0,0,0,0,0,0,15
2022,Iran (Islamic Rep. of),IRN,Sweden,SWE,0,0,0,0,0,267,267,0,0,0,0,0,384,384,7523
2022,Iraq,IRQ,Sweden,SWE,0,0,0,0,0,497,497,0,0,0,0,0,959,959,11753
2022,Israel,ISR,Sweden,SWE,0,0,0,0,0,0,0,0,0,0,0,0,0,0,22
2022,Jamaica,JAM,Sweden,SWE,0,0,0,0,0,0,0,0,0,0,0,0,0,0,5
2022,Jordan,JOR,Sweden,SWE,0,0,0,0,0,36,36,0,0,0,0,0,75,75,402
2022,Kazakhstan,KAZ,Sweden,SWE,0,0,0,0,0,51,51,0,0,0,0,0,55,55,313
2022,Kenya,KEN,Sweden,SWE,0,0,0,0,0,16,16,0,0,0,0,0,5,5,103
2022,Kyrgyzstan,KGZ,Sweden,SWE,0,0,0,0,0,20,20,0,0,0,0,0,45,45,219
2022,Rep. of Korea,KOR,Sweden,SWE,0,0,0,0,0,5,5,0,0,0,0,0,0,0,13
2022,Dem. People's Rep. of Korea,PRK,Sweden,SWE,0,0,0,0,0,0,0,0,0,0,0,0,0,0,5
2022,Kuwait,KWT,Sweden,SWE,0,0,0,0,0,5,5,0,0,0,0,0,0,0,35
2022,Liberia,LBR,Sweden,SWE,0,0,0,0,0,0,0,0,0,0,0,0,0,0,11
2022,Libya,LBY,Sweden,SWE,0,0,0,0,0,5,5,0,0,0,0,0,35,35,285
2022,Lebanon,LBN,Sweden,SWE,0,0,0,0,0,90,90,0,0,0,0,0,143,143,751
2022,Sri Lanka,LKA,Sweden,SWE,0,0,0,0,0,16,16,0,0,0,0,0,16,16,58
2022,Lithuania,LTU,Sweden,SWE,0,0,0,0,0,0,0,0,0,0,0,0,0,0,7
2022,Mauritania,MRT,Sweden,SWE,0,0,0,0,0,0,0,0,0,0,0,0,0,0,13
2022,North Macedonia,MKD,Sweden,SWE,0,0,0,0,0,5,5,0,0,0,0,0,16,16,58
2022,Rep. of Moldova,MDA,Sweden,SWE,0,0,0,0,0,6,6,0,0,0,0,0,10,10,39
2022,Mexico,MEX,Sweden,SWE,0,0,0,0,0,0,0,0,0,0,0,0,0,0,5
2022,Mali,MLI,Sweden,SWE,0,0,0,0,0,0,0,0,0,0,0,0,0,0,38
2022,Malaysia,MYS,Sweden,SWE,0,0,0,0,0,0,0,0,0,0,0,0,0,0,14
2022,Montenegro,MNE,Sweden,SWE,0,0,0,0,0,9,9,0,0,0,0,0,0,0,30
2022,Mongolia,MNG,Sweden,SWE,0,0,0,0,0,70,70,0,0,0,0,0,50,50,356
2022,Morocco,MAR,Sweden,SWE,0,0,0,0,0,40,40,0,0,0,0,0,97,97,398
2022,Myanmar,MMR,Sweden,SWE,0,0,0,0,0,9,9,0,0,0,0,0,0,0,18
2022,Nepal,NPL,Sweden,SWE,0,0,0,0,0,0,0,0,0,0,0,0,0,0,13
2022,Niger,NER,Sweden,SWE,0,0,0,0,0,0,0,0,0,0,0,0,0,0,5
2022,Nicaragua,NIC,Sweden,SWE,0,0,0,0,0,60,60,0,0,0,0,0,104,104,234
2022,Nigeria,NGA,Sweden,SWE,0,0,0,0,0,99,99,0,0,0,0,0,168,168,883
2022,Pakistan,PAK,Sweden,SWE,0,0,0,0,0,64,64,0,0,0,0,0,93,93,737
2022,Paraguay,PRY,Sweden,SWE,0,0,0,0,0,0,0,0,0,0,0,0,0,0,5
2022,Peru,PER,Sweden,SWE,0,0,0,0,0,101,101,0,0,0,0,0,101,101,210
2022,Philippines,PHL,Sweden,SWE,0,0,0,0,0,10,10,0,0,0,0,0,0,0,15
2022,Poland,POL,Sweden,SWE,0,0,0,0,0,0,0,0,0,0,0,0,0,0,5
2022,Romania,ROU,Sweden,SWE,0,0,0,0,0,0,0,0,0,0,0,0,0,0,38
2022,South Africa,ZAF,Sweden,SWE,0,0,0,0,0,6,6,0,0,0,0,0,11,11,17
2022,Russian Federation,RUS,Sweden,SWE,0,0,0,0,0,260,260,0,0,0,0,0,333,333,1934
2022,Rwanda,RWA,Sweden,SWE,0,0,0,0,0,15,15,0,0,0,0,0,14,14,91
2022,El Salvador,SLV,Sweden,SWE,0,0,0,0,0,50,50,0,0,0,0,0,58,58,246
2022,Saudi Arabia,SAU,Sweden,SWE,0,0,0,0,0,0,0,0,0,0,0,0,0,0,62
2022,Senegal,SEN,Sweden,SWE,0,0,0,0,0,5,5,0,0,0,0,0,7,7,65
2022,Sierra Leone,SLE,Sweden,SWE,0,0,0,0,0,5,5,0,0,0,0,0,15,15,83
2022,Somalia,SOM,Sweden,SWE,0,0,0,0,0,155,155,0,0,0,0,0,228,228,8690
2022,Serbia and Kosovo: S/RES/1244 (1999),SRB,Sweden,SWE,0,0,0,0,0,107,107,0,0,0,0,0,110,110,725
2022,Viet Nam,VNM,Sweden,SWE,0,0,0,0,0,24,24,0,0,0,0,0,18,18,78
2022,South Sudan,SSD,Sweden,SWE,0,0,0,0,0,0,0,0,0,0,0,0,0,0,64
2022,Stateless,XXA,Sweden,SWE,0,0,0,0,0,188,188,0,0,0,0,0,295,295,21474
2022,Sudan,SDN,Sweden,SWE,0,0,0,0,0,21,21,0,0,0,0,0,35,35,1116
2022,Eswatini,SWZ,Sweden,SWE,0,0,0,0,0,0,0,0,0,0,0,0,0,0,5
2022,Syrian Arab Rep.,SYR,Sweden,SWE,0,0,0,0,0,447,447,0,0,0,0,0,786,786,112432
2022,United Rep. of Tanzania,TZA,Sweden,SWE,0,0,0,0,0,20,20,0,0,0,0,0,18,18,106
2022,Thailand,THA,Sweden,SWE,0,0,0,0,0,10,10,0,0,0,0,0,0,0,15
2022,Tajikistan,TJK,Sweden,SWE,0,0,0,0,0,21,21,0,0,0,0,0,46,46,146
2022,Turkmenistan,TKM,Sweden,SWE,0,0,0,0,0,6,6,0,0,0,0,0,10,10,40
2022,Tunisia,TUN,Sweden,SWE,0,0,0,0,0,15,15,0,0,0,0,0,43,43,105
2022,Türkiye,TUR,Sweden,SWE,0,0,0,0,0,130,130,0,0,0,0,0,308,308,3033
2022,United Arab Emirates,ARE,Sweden,SWE,0,0,0,0,0,0,0,0,0,0,0,0,0,0,5
2022,Uganda,UGA,Sweden,SWE,0,0,0,0,0,60,60,0,0,0,0,0,35,35,803
2022,Unknown ,UNK,Sweden,SWE,0,0,0,0,0,0,0,0,0,0,0,0,0,0,729
2022,Ukraine,UKR,Sweden,SWE,0,0,0,0,0,29666,29666,0,0,0,0,0,17834,17834,47846
2022,United States of America,USA,Sweden,SWE,0,0,0,0,0,5,5,0,0,0,0,0,7,7,42
2022,Uzbekistan,UZB,Sweden,SWE,0,0,0,0,0,96,96,0,0,0,0,0,351,351,948
2022,Venezuela (Bolivarian Republic of),VEN,Sweden,SWE,0,0,0,0,0,30,30,0,0,0,0,0,29,29,100
2022,Yemen,YEM,Sweden,SWE,0,0,0,0,0,27,27,0,0,0,0,0,40,40,1798
2022,Zambia,ZMB,Sweden,SWE,0,0,0,0,0,0,0,0,0,0,0,0,0,0,11
2022,Zimbabwe,ZWE,Sweden,SWE,0,0,0,0,0,7,7,0,0,0,0,0,6,6,27
2022,Afghanistan,AFG,Switzerland,CHE,307,699,499,2087,152,35,3779,359,742,3724,7533,154,55,12567,20600
2022,Albania,ALB,Switzerland,CHE,0,8,15,50,0,0,73,5,10,12,55,0,0,82,184
2022,Algeria,DZA,Switzerland,CHE,5,0,5,27,5,0,42,0,8,51,294,6,20,379,497
2022,Angola,AGO,Switzerland,CHE,15,35,48,228,23,0,349,28,45,39,177,28,0,317,702
2022,Egypt,EGY,Switzerland,CHE,0,0,0,12,0,0,12,0,0,0,23,6,15,44,174
2022,Armenia,ARM,Switzerland,CHE,5,5,15,54,9,40,128,5,5,14,61,5,25,115,251
2022,Austria,AUT,Switzerland,CHE,0,0,0,0,0,0,0,0,0,0,0,0,0,0,5
2022,Azerbaijan,AZE,Switzerland,CHE,5,10,11,33,5,30,94,0,14,7,49,0,50,120,387
2022,Burundi,BDI,Switzerland,CHE,40,31,47,286,0,0,404,33,33,51,609,0,0,726,1264
2022,Benin,BEN,Switzerland,CHE,5,0,0,5,0,0,10,0,0,6,0,0,0,6,30
2022,Bangladesh,BGD,Switzerland,CHE,0,0,0,7,0,5,12,0,0,5,15,0,10,30,59
2022,Burkina Faso,BFA,Switzerland,CHE,0,0,0,6,0,0,6,0,0,0,14,0,0,14,29
2022,Belarus,BLR,Switzerland,CHE,5,0,5,16,0,60,86,0,5,7,29,0,70,111,197
2022,Bolivia (Plurinational State of),BOL,Switzerland,CHE,0,0,0,0,0,0,0,0,0,5,0,0,0,5,5
2022,Brazil,BRA,Switzerland,CHE,0,0,0,14,0,0,14,0,0,0,0,0,0,0,20
2022,Bosnia and Herzegovina,BIH,Switzerland,CHE,5,10,14,93,35,0,157,6,18,9,79,17,0,129,1404
2022,Bulgaria,BGR,Switzerland,CHE,0,0,0,0,0,0,0,0,0,0,0,0,0,0,9
2022,Cambodia,KHM,Switzerland,CHE,0,0,0,0,0,0,0,0,0,0,0,0,0,0,265
2022,Canada,CAN,Switzerland,CHE,0,0,0,0,0,0,0,0,5,0,0,0,5,10,10
2022,Central African Rep.,CAF,Switzerland,CHE,0,0,0,5,0,0,5,0,0,0,7,0,0,7,22
2022,Chad,TCD,Switzerland,CHE,7,0,0,0,0,0,7,0,0,0,18,0,0,18,46
2022,China,CHN,Switzerland,CHE,97,62,36,445,8,5,653,81,60,22,541,14,15,733,2345
2022,Chile,CHL,Switzerland,CHE,0,0,0,0,0,0,0,5,0,0,0,0,0,5,14
2022,Cameroon,CMR,Switzerland,CHE,8,12,13,66,5,5,109,8,13,5,55,6,15,102,299
2022,Congo,COG,Switzerland,CHE,0,0,0,15,0,0,15,0,0,0,13,0,0,13,55
2022,Dem. Rep. of the Congo,COD,Switzerland,CHE,35,58,47,362,46,0,548,43,67,46,242,17,10,425,1305
2022,Colombia,COL,Switzerland,CHE,5,14,7,58,5,0,89,5,18,5,88,0,0,116,476
2022,Cuba,CUB,Switzerland,CHE,0,5,0,24,0,0,29,0,8,0,26,0,5,39,94
2022,Djibouti,DJI,Switzerland,CHE,0,5,0,0,0,0,5,0,0,0,5,0,0,5,23
2022,Ecuador,ECU,Switzerland,CHE,0,0,0,0,0,0,0,5,0,0,0,0,0,5,5
2022,Equatorial Guinea,GNQ,Switzerland,CHE,5,0,5,0,0,0,10,0,0,0,0,0,0,0,10
2022,Eritrea,ERI,Switzerland,CHE,556,608,254,2662,83,0,4163,543,644,302,3266,46,0,4801,38799
2022,Ethiopia,ETH,Switzerland,CHE,68,88,37,406,6,0,605,80,90,37,362,9,5,583,2011
2022,France,FRA,Switzerland,CHE,0,0,0,0,0,0,0,0,0,0,0,0,0,0,9
2022,Gabon,GAB,Switzerland,CHE,0,5,0,0,0,0,5,0,0,0,0,0,0,0,10
2022,Gambia,GMB,Switzerland,CHE,5,0,0,5,0,0,10,0,0,5,44,0,0,49,80
2022,United Kingdom of Great Britain and Northern Ireland,GBR,Switzerland,CHE,0,5,0,0,0,0,5,0,0,0,5,0,0,5,10
2022,Georgia,GEO,Switzerland,CHE,11,31,18,164,21,25,270,16,40,21,234,23,60,394,676
2022,Germany,DEU,Switzerland,CHE,0,0,0,0,0,0,0,0,0,0,0,0,0,0,6
2022,Ghana,GHA,Switzerland,CHE,6,0,0,5,0,0,11,0,0,0,14,0,0,14,33
2022,Guinea-Bissau,GNB,Switzerland,CHE,0,0,5,9,0,0,14,0,0,5,21,0,0,26,46
2022,Greece,GRC,Switzerland,CHE,0,5,0,0,0,0,5,0,0,5,0,0,0,5,10
2022,Guatemala,GTM,Switzerland,CHE,0,0,0,0,0,0,0,0,0,0,12,0,0,12,12
2022,Guinea,GIN,Switzerland,CHE,7,7,0,23,0,0,37,0,9,17,110,0,0,136,223
2022,Haiti,HTI,Switzerland,CHE,0,0,0,0,0,0,0,0,0,0,8,0,0,8,8
2022,Honduras,HND,Switzerland,CHE,8,0,5,0,0,0,13,0,0,0,0,0,0,0,13
2022,Croatia,HRV,Switzerland,CHE,0,0,0,0,0,0,0,0,0,0,5,0,0,5,18
2022,Cote d'Ivoire,CIV,Switzerland,CHE,6,7,5,43,0,0,61,0,0,7,50,0,0,57,206
2022,India,IND,Switzerland,CHE,0,0,5,15,0,5,25,10,0,0,14,0,15,39,71
2022,Indonesia,IDN,Switzerland,CHE,0,6,0,0,0,0,6,0,0,0,0,0,0,0,6
2022,Iran (Islamic Rep. of),IRN,Switzerland,CHE,36,60,57,456,23,10,642,45,74,69,673,35,15,911,3083
2022,Iraq,IRQ,Switzerland,CHE,85,218,160,597,37,5,1102,84,218,188,1053,45,20,1608,4825
2022,Israel,ISR,Switzerland,CHE,0,0,0,0,0,5,5,0,0,0,0,0,9,9,19
2022,Italy,ITA,Switzerland,CHE,0,0,8,0,0,0,8,0,0,0,5,0,0,5,20
2022,Jamaica,JAM,Switzerland,CHE,0,0,0,0,0,0,0,0,0,0,0,0,0,0,8
2022,Jordan,JOR,Switzerland,CHE,0,0,7,5,0,0,12,0,0,0,16,0,10,26,73
2022,Kazakhstan,KAZ,Switzerland,CHE,0,0,0,7,0,0,7,5,0,0,9,0,5,19,41
2022,Kenya,KEN,Switzerland,CHE,0,0,0,18,0,0,18,0,8,0,0,0,0,8,46
2022,Kyrgyzstan,KGZ,Switzerland,CHE,0,0,0,5,5,0,10,0,5,0,6,0,0,11,37
2022,Rep. of Korea,KOR,Switzerland,CHE,0,0,0,5,0,0,5,0,0,0,0,0,0,0,5
2022,Lao People's Dem. Rep.,LAO,Switzerland,CHE,0,0,0,0,0,0,0,0,0,0,0,0,0,0,104
2022,Liberia,LBR,Switzerland,CHE,0,0,0,5,0,5,10,0,0,0,11,0,0,11,37
2022,Libya,LBY,Switzerland,CHE,6,21,7,22,0,0,56,0,12,10,89,5,5,121,347
2022,Lebanon,LBN,Switzerland,CHE,0,5,6,21,0,0,32,0,8,0,29,5,25,67,115
2022,Sri Lanka,LKA,Switzerland,CHE,37,55,49,359,111,0,611,32,44,49,786,72,10,993,6444
2022,Madagascar,MDG,Switzerland,CHE,0,0,0,0,5,0,5,0,0,0,0,0,0,0,5
2022,Mauritania,MRT,Switzerland,CHE,0,0,0,0,0,0,0,0,0,0,14,0,0,14,14
2022,North Macedonia,MKD,Switzerland,CHE,10,22,7,53,5,0,97,10,19,12,41,0,0,82,198
2022,Rep. of Moldova,MDA,Switzerland,CHE,0,0,0,8,0,29,37,0,0,0,7,0,24,31,73
2022,Mexico,MEX,Switzerland,CHE,0,0,0,5,0,0,5,0,0,0,0,0,0,0,5
2022,Mali,MLI,Switzerland,CHE,5,0,0,5,0,0,10,0,0,0,22,0,0,22,72
2022,Montenegro,MNE,Switzerland,CHE,14,0,7,24,0,0,45,5,6,0,11,0,0,22,72
2022,Mongolia,MNG,Switzerland,CHE,9,19,6,53,6,0,93,10,11,17,30,5,0,73,172
2022,Morocco,MAR,Switzerland,CHE,0,9,5,22,5,5,46,0,0,30,150,0,25,205,286
2022,Myanmar,MMR,Switzerland,CHE,0,5,0,8,0,0,13,0,0,0,21,0,0,21,66
2022,Namibia,NAM,Switzerland,CHE,0,0,0,0,0,0,0,0,0,0,5,0,0,5,5
2022,Nepal,NPL,Switzerland,CHE,0,0,0,13,0,0,13,0,0,0,5,0,0,5,27
2022,Niger,NER,Switzerland,CHE,0,0,0,0,0,0,0,0,0,0,12,0,0,12,12
2022,Nicaragua,NIC,Switzerland,CHE,0,0,0,9,0,0,9,0,0,0,0,0,0,0,18
2022,Nigeria,NGA,Switzerland,CHE,25,34,12,95,0,10,176,26,27,15,107,0,25,200,401
2022,Pakistan,PAK,Switzerland,CHE,5,17,13,47,0,0,82,6,18,27,129,0,20,200,429
2022,Paraguay,PRY,Switzerland,CHE,0,5,0,0,0,0,5,0,0,0,0,0,0,0,5
2022,Peru,PER,Switzerland,CHE,0,0,0,0,0,0,0,0,0,0,7,0,0,7,12
2022,Philippines,PHL,Switzerland,CHE,0,0,0,7,0,0,7,0,0,6,0,0,0,6,13
2022,Poland,POL,Switzerland,CHE,0,0,0,0,0,0,0,0,0,0,0,0,0,0,8
2022,Portugal,PRT,Switzerland,CHE,0,0,0,0,0,0,0,0,0,0,0,0,0,0,8
2022,Romania,ROU,Switzerland,CHE,0,0,0,0,0,0,0,0,0,0,0,0,0,0,20
2022,South Africa,ZAF,Switzerland,CHE,0,0,0,6,0,0,6,0,5,0,0,0,0,5,11
2022,Russian Federation,RUS,Switzerland,CHE,18,34,25,131,25,195,428,13,37,34,153,7,155,399,1278
2022,Rwanda,RWA,Switzerland,CHE,7,0,0,0,0,0,7,0,0,0,16,0,0,16,108
2022,El Salvador,SLV,Switzerland,CHE,0,0,0,13,0,0,13,0,0,0,11,0,0,11,24
2022,Saudi Arabia,SAU,Switzerland,CHE,0,0,0,5,0,0,5,0,0,5,0,0,0,5,18
2022,Senegal,SEN,Switzerland,CHE,7,8,5,15,0,0,35,0,6,0,12,0,0,18,80
2022,Sierra Leone,SLE,Switzerland,CHE,0,0,11,9,0,0,20,0,0,5,31,0,0,36,62
2022,Somalia,SOM,Switzerland,CHE,116,134,96,632,51,0,1029,152,165,174,1134,40,10,1675,4476
2022,Spain,ESP,Switzerland,CHE,0,0,0,0,0,0,0,0,0,0,0,0,0,0,8
2022,Serbia and Kosovo: S/RES/1244 (1999),SRB,Switzerland,CHE,47,65,100,491,79,0,782,37,81,89,455,71,0,733,1998
2022,Viet Nam,VNM,Switzerland,CHE,0,0,0,0,0,25,25,0,0,0,5,0,25,30,779
2022,South Sudan,SSD,Switzerland,CHE,0,0,0,5,0,0,5,5,0,0,7,0,0,12,96
2022,Stateless,XXA,Switzerland,CHE,0,0,0,0,0,0,0,0,0,5,0,0,15,20,865
2022,Sudan,SDN,Switzerland,CHE,5,5,5,29,0,0,44,0,5,13,71,0,0,89,578
2022,Syrian Arab Rep.,SYR,Switzerland,CHE,284,533,409,1923,269,0,3418,290,589,502,2579,235,10,4205,20794
2022,United Rep. of Tanzania,TZA,Switzerland,CHE,0,0,0,12,0,0,12,0,7,0,0,0,0,7,19
2022,Tajikistan,TJK,Switzerland,CHE,0,0,0,9,0,0,9,0,0,0,0,0,5,5,41
2022,Turkmenistan,TKM,Switzerland,CHE,0,0,0,0,0,7,7,0,0,0,7,0,16,23,30
2022,Togo,TGO,Switzerland,CHE,0,5,7,21,0,0,33,0,0,8,25,5,0,38,509
2022,Tunisia,TUN,Switzerland,CHE,0,6,5,19,0,0,30,0,5,12,100,0,15,132,306
2022,Türkiye,TUR,Switzerland,CHE,114,179,106,841,21,5,1266,139,221,166,2602,40,155,3323,12739
2022,Uganda,UGA,Switzerland,CHE,0,0,6,27,0,0,33,0,0,9,9,0,0,18,87
2022,Unknown ,UNK,Switzerland,CHE,23,34,31,153,14,5,260,28,45,36,206,26,0,341,1402
2022,Ukraine,UKR,Switzerland,CHE,14,18,12,99,21,39640,39804,10,28,15,62,10,20330,20455,60271
2022,United States of America,USA,Switzerland,CHE,0,0,0,0,0,7,7,0,0,0,5,0,6,11,18
2022,Uzbekistan,UZB,Switzerland,CHE,0,0,0,5,0,15,20,0,7,0,14,0,15,36,105
2022,Venezuela (Bolivarian Republic of),VEN,Switzerland,CHE,0,11,0,28,5,0,44,0,6,0,47,6,0,59,138
2022,Western Sahara,ESH,Switzerland,CHE,0,0,0,0,0,0,0,0,0,0,0,0,0,0,5
2022,Yemen,YEM,Switzerland,CHE,0,5,6,34,8,0,53,0,5,11,48,6,0,70,361
2022,Zimbabwe,ZWE,Switzerland,CHE,0,9,0,0,0,0,9,0,0,0,5,0,0,5,14
2022,Venezuela (Bolivarian Republic of),VEN,Sint Maarten (Dutch part),SXM,0,0,0,0,0,0,0,0,0,0,0,0,0,0,122
2022,Afghanistan,AFG,Syrian Arab Rep.,SYR,62,65,70,354,25,0,576,51,96,88,374,54,0,663,1239
2022,Algeria,DZA,Syrian Arab Rep.,SYR,0,0,5,0,0,0,5,0,0,0,0,0,0,0,5
2022,Egypt,EGY,Syrian Arab Rep.,SYR,0,6,0,15,0,0,21,0,0,6,17,0,0,23,44
2022,Bahrain,BHR,Syrian Arab Rep.,SYR,0,10,0,0,0,0,10,0,0,0,0,0,0,0,10
2022,Bangladesh,BGD,Syrian Arab Rep.,SYR,0,0,0,0,0,0,0,0,0,0,5,0,0,5,5
2022,Burkina Faso,BFA,Syrian Arab Rep.,SYR,0,0,0,0,0,0,0,5,0,0,0,0,0,5,5
2022,Chad,TCD,Syrian Arab Rep.,SYR,0,0,9,0,0,0,9,0,0,0,0,0,0,0,9
2022,Eritrea,ERI,Syrian Arab Rep.,SYR,0,0,5,11,0,0,16,0,0,0,5,0,0,5,21
2022,Ethiopia,ETH,Syrian Arab Rep.,SYR,0,0,0,12,0,0,12,0,0,0,0,0,0,0,12
2022,Guinea,GIN,Syrian Arab Rep.,SYR,5,8,10,16,0,0,39,0,6,5,11,0,0,22,61
2022,Cote d'Ivoire,CIV,Syrian Arab Rep.,SYR,0,0,0,0,0,0,0,0,0,0,5,0,0,5,5
2022,Iran (Islamic Rep. of),IRN,Syrian Arab Rep.,SYR,0,5,5,24,0,0,34,0,5,0,16,0,0,21,55
2022,Iraq,IRQ,Syrian Arab Rep.,SYR,445,862,838,2801,415,0,5361,457,909,776,2456,641,0,5239,15228
2022,Jordan,JOR,Syrian Arab Rep.,SYR,0,0,0,17,0,0,17,0,0,5,5,0,0,10,27
2022,Libya,LBY,Syrian Arab Rep.,SYR,5,0,0,5,0,0,10,0,0,5,0,0,0,5,15
2022,Lebanon,LBN,Syrian Arab Rep.,SYR,5,8,5,14,6,0,38,0,0,5,0,0,0,5,43
2022,Sri Lanka,LKA,Syrian Arab Rep.,SYR,0,0,0,5,0,0,5,0,0,0,0,0,0,0,5
2022,Morocco,MAR,Syrian Arab Rep.,SYR,0,0,0,5,0,0,5,0,0,0,0,0,0,0,5
2022,Nigeria,NGA,Syrian Arab Rep.,SYR,0,0,0,0,0,0,0,0,6,0,0,0,0,6,6
2022,Pakistan,PAK,Syrian Arab Rep.,SYR,21,31,7,45,5,0,109,16,42,10,60,5,0,133,242
2022,Saudi Arabia,SAU,Syrian Arab Rep.,SYR,0,0,0,5,0,0,5,0,0,0,0,0,0,0,5
2022,Sierra Leone,SLE,Syrian Arab Rep.,SYR,0,6,0,6,0,0,12,0,0,0,5,0,0,5,17
2022,Somalia,SOM,Syrian Arab Rep.,SYR,6,19,24,130,17,0,196,10,18,27,73,0,0,128,324
2022,South Sudan,SSD,Syrian Arab Rep.,SYR,0,0,14,21,0,0,35,0,0,10,26,5,0,41,76
2022,Sudan,SDN,Syrian Arab Rep.,SYR,20,66,95,188,5,0,374,27,60,57,212,74,0,430,804
2022,Tunisia,TUN,Syrian Arab Rep.,SYR,0,0,5,0,0,0,5,0,0,0,5,0,0,5,10
2022,Türkiye,TUR,Syrian Arab Rep.,SYR,0,0,0,0,0,0,0,0,0,5,5,0,0,10,16
2022,Unknown ,UNK,Syrian Arab Rep.,SYR,0,0,0,11,0,0,11,0,0,0,0,0,0,0,11
2022,Yemen,YEM,Syrian Arab Rep.,SYR,5,30,37,77,0,0,149,20,24,39,122,0,0,205,354
2022,Burundi,BDI,United Rep. of Tanzania,TZA,16118,16825,11652,34540,2248,0,81383,16319,17364,11904,34827,2486,0,82900,164283
2022,Dem. Rep. of the Congo,COD,United Rep. of Tanzania,TZA,7527,7120,5433,14491,1442,0,36013,7670,7183,5367,12912,1079,0,34211,70224
2022,Iran (Islamic Rep. of),IRN,United Rep. of Tanzania,TZA,0,0,0,5,0,0,5,0,0,0,0,0,0,0,5
2022,Kenya,KEN,United Rep. of Tanzania,TZA,0,6,0,0,0,0,6,0,0,0,0,0,0,0,6
2022,Lebanon,LBN,United Rep. of Tanzania,TZA,0,0,5,0,0,0,5,0,0,0,0,0,0,0,5
2022,Rwanda,RWA,United Rep. of Tanzania,TZA,6,14,0,25,5,0,50,12,13,0,27,0,0,52,102
2022,Somalia,SOM,United Rep. of Tanzania,TZA,6,7,14,52,0,0,79,5,8,12,58,0,0,83,162
2022,South Sudan,SSD,United Rep. of Tanzania,TZA,0,0,0,0,0,0,0,0,0,6,5,0,0,11,11
2022,Sudan,SDN,United Rep. of Tanzania,TZA,0,0,0,6,0,0,6,0,0,0,0,0,0,0,6
2022,Syrian Arab Rep.,SYR,United Rep. of Tanzania,TZA,0,0,5,6,0,0,11,0,0,10,15,0,0,25,36
2022,Türkiye,TUR,United Rep. of Tanzania,TZA,0,0,0,5,0,0,5,0,0,0,5,0,0,5,10
2022,Uganda,UGA,United Rep. of Tanzania,TZA,0,5,0,0,0,0,5,0,0,6,12,0,0,18,23
2022,Unknown ,UNK,United Rep. of Tanzania,TZA,6,0,0,0,0,0,6,0,0,0,0,0,0,0,6
2022,Yemen,YEM,United Rep. of Tanzania,TZA,0,8,5,16,0,0,29,5,0,9,47,5,0,66,95
2022,Sri Lanka,LKA,Turks and Caicos Islands,TCA,0,0,0,0,0,0,0,0,0,0,0,0,0,0,7
2022,Afghanistan,AFG,Thailand,THA,9,5,5,33,0,0,52,10,13,9,62,0,0,94,146
2022,Egypt,EGY,Thailand,THA,0,0,0,7,0,0,7,0,0,0,11,0,0,11,18
2022,Cambodia,KHM,Thailand,THA,12,18,10,117,11,0,168,13,13,17,123,9,0,175,343
2022,China,CHN,Thailand,THA,0,11,6,83,15,0,115,5,14,13,95,9,0,136,251
2022,Cameroon,CMR,Thailand,THA,0,0,0,21,0,0,21,7,0,0,51,0,0,58,79
2022,Dem. Rep. of the Congo,COD,Thailand,THA,0,11,0,6,0,0,17,0,0,0,6,0,0,6,23
2022,Ethiopia,ETH,Thailand,THA,5,0,0,5,0,0,10,0,0,0,12,0,0,12,22
2022,Palestinian,PSE,Thailand,THA,5,9,9,35,8,0,66,5,9,8,95,9,0,126,192
2022,Guinea,GIN,Thailand,THA,0,5,0,0,0,0,5,0,0,0,0,0,0,0,5
2022,Cote d'Ivoire,CIV,Thailand,THA,0,9,0,0,0,0,9,0,0,0,9,0,0,9,18
2022,Iran (Islamic Rep. of),IRN,Thailand,THA,0,0,6,24,0,0,30,0,7,0,49,6,0,62,92
2022,Iraq,IRQ,Thailand,THA,0,6,5,31,5,0,47,0,10,13,75,6,0,104,151
2022,Lao People's Dem. Rep.,LAO,Thailand,THA,0,0,0,0,0,0,0,0,0,0,11,0,0,11,11
2022,Lebanon,LBN,Thailand,THA,0,0,0,0,0,0,0,0,0,0,5,0,0,5,5
2022,Sri Lanka,LKA,Thailand,THA,0,6,6,32,0,0,44,0,12,16,43,0,0,71,115
2022,Morocco,MAR,Thailand,THA,0,0,0,10,0,0,10,0,0,0,0,0,0,0,10
2022,Myanmar,MMR,Thailand,THA,2316,6969,6570,26462,3485,0,45802,2374,7414,6680,25056,3293,0,44817,90619
2022,Nepal,NPL,Thailand,THA,0,0,0,0,0,0,0,0,0,0,5,0,0,5,5
2022,Nigeria,NGA,Thailand,THA,0,0,0,0,0,0,0,5,0,0,12,0,0,17,17
2022,Pakistan,PAK,Thailand,THA,56,116,75,384,26,0,657,66,120,98,487,25,0,796,1453
2022,Russian Federation,RUS,Thailand,THA,0,0,0,5,0,0,5,0,0,0,0,0,0,0,5
2022,Somalia,SOM,Thailand,THA,6,17,9,57,0,0,89,9,14,7,46,0,0,76,165
2022,Viet Nam,VNM,Thailand,THA,64,109,80,352,28,0,633,80,117,81,437,31,0,746,1379
2022,Sudan,SDN,Thailand,THA,0,0,0,0,0,0,0,0,0,5,0,0,0,5,5
2022,Syrian Arab Rep.,SYR,Thailand,THA,5,0,7,21,5,0,38,6,10,10,142,8,0,176,214
2022,United Rep. of Tanzania,TZA,Thailand,THA,0,0,0,5,0,0,5,0,0,0,0,0,0,0,5
2022,Yemen,YEM,Thailand,THA,5,0,0,9,0,0,14,0,8,0,14,5,0,27,41
2022,Zimbabwe,ZWE,Thailand,THA,0,0,0,0,0,0,0,9,0,0,0,0,0,9,9
2022,Afghanistan,AFG,Tajikistan,TJK,302,734,625,2818,260,0,4739,371,766,714,2759,304,0,4914,9714
2022,Iran (Islamic Rep. of),IRN,Tajikistan,TJK,0,0,0,0,0,0,0,0,0,0,7,0,0,7,7
2022,Afghanistan,AFG,Turkmenistan,TKM,0,0,0,0,0,0,0,0,0,0,9,0,0,9,9
2022,Azerbaijan,AZE,Turkmenistan,TKM,0,0,0,0,5,0,5,0,0,0,0,0,0,0,5
2022,Burundi,BDI,Togo,TGO,0,0,0,0,0,0,0,0,0,0,5,0,0,5,5
2022,Benin,BEN,Togo,TGO,0,7,6,5,0,0,18,0,5,0,21,5,0,31,49
2022,Burkina Faso,BFA,Togo,TGO,0,0,0,0,0,0,0,0,0,0,7,0,0,7,7
2022,Central African Rep.,CAF,Togo,TGO,10,21,16,145,5,0,197,9,20,20,210,0,0,259,456
2022,Chad,TCD,Togo,TGO,0,0,0,18,0,0,18,0,5,0,14,0,0,19,37
2022,Cameroon,CMR,Togo,TGO,5,0,0,5,0,0,10,0,0,5,19,0,0,24,34
2022,Congo,COG,Togo,TGO,0,0,10,18,0,0,28,0,0,14,34,0,0,48,76
2022,Dem. Rep. of the Congo,COD,Togo,TGO,0,18,11,56,0,0,85,5,20,9,75,5,0,114,199
2022,Gabon,GAB,Togo,TGO,0,0,5,0,0,0,5,0,0,0,0,0,0,0,5
2022,Palestinian,PSE,Togo,TGO,0,0,0,0,0,0,0,0,0,0,5,0,0,5,5
2022,Ghana,GHA,Togo,TGO,0,547,1351,2583,445,0,4926,0,598,1314,1481,194,0,3587,8513
2022,Cote d'Ivoire,CIV,Togo,TGO,0,0,0,14,5,0,19,0,0,5,19,0,0,24,43
2022,Iraq,IRQ,Togo,TGO,0,0,0,0,0,0,0,0,6,0,0,0,0,6,6
2022,Liberia,LBR,Togo,TGO,0,0,0,0,0,0,0,0,0,6,0,0,0,6,6
2022,Lebanon,LBN,Togo,TGO,0,0,0,5,0,0,5,5,0,0,26,0,0,31,36
2022,Sri Lanka,LKA,Togo,TGO,0,0,0,0,0,0,0,0,0,0,5,0,0,5,5
2022,Mali,MLI,Togo,TGO,0,10,16,26,0,0,52,0,13,11,35,6,0,65,117
2022,Niger,NER,Togo,TGO,0,5,0,0,0,0,5,0,5,0,0,0,0,5,10
2022,Nigeria,NGA,Togo,TGO,0,0,0,11,0,0,11,0,5,0,15,0,0,20,31
2022,Rwanda,RWA,Togo,TGO,6,12,0,41,0,0,59,0,7,6,41,5,0,59,118
2022,Somalia,SOM,Togo,TGO,0,5,0,0,0,0,5,0,0,0,0,0,0,0,5
2022,Syrian Arab Rep.,SYR,Togo,TGO,9,0,5,0,0,0,14,0,0,5,21,0,0,26,40
2022,Türkiye,TUR,Togo,TGO,0,0,7,22,0,0,29,6,7,10,21,0,0,44,73
2022,Antigua and Barbuda,ATG,Trinidad and Tobago,TTO,0,0,0,0,0,0,0,0,0,0,0,0,0,0,5
2022,Bangladesh,BGD,Trinidad and Tobago,TTO,0,0,0,0,0,0,0,0,0,0,91,0,0,91,91
2022,China,CHN,Trinidad and Tobago,TTO,0,0,0,21,0,0,21,0,0,0,21,0,0,21,42
2022,Cameroon,CMR,Trinidad and Tobago,TTO,0,0,0,6,0,0,6,0,0,0,6,0,0,6,12
2022,Colombia,COL,Trinidad and Tobago,TTO,0,0,0,39,0,0,39,5,0,0,21,0,0,26,65
2022,Cuba,CUB,Trinidad and Tobago,TTO,5,16,10,506,14,0,551,5,22,23,887,5,0,942,1493
2022,Dominican Rep.,DOM,Trinidad and Tobago,TTO,0,5,0,55,0,0,60,0,0,0,43,5,0,48,108
2022,Ghana,GHA,Trinidad and Tobago,TTO,0,0,0,6,0,0,6,0,0,0,43,0,0,43,49
2022,Grenada,GRD,Trinidad and Tobago,TTO,0,0,0,0,0,0,0,0,0,0,0,0,0,0,5
2022,Guyana,GUY,Trinidad and Tobago,TTO,0,0,6,50,0,0,56,0,5,5,38,0,0,48,104
2022,Haiti,HTI,Trinidad and Tobago,TTO,0,0,0,11,0,0,11,0,0,0,10,0,0,10,21
2022,India,IND,Trinidad and Tobago,TTO,0,0,0,0,0,0,0,0,0,0,5,0,0,5,5
2022,Jamaica,JAM,Trinidad and Tobago,TTO,0,0,19,126,7,0,152,0,0,9,157,0,0,166,318
2022,Sri Lanka,LKA,Trinidad and Tobago,TTO,0,0,0,0,0,0,0,0,0,0,5,0,0,5,5
2022,Mexico,MEX,Trinidad and Tobago,TTO,0,0,0,0,0,0,0,0,0,0,0,0,0,0,6
2022,Nigeria,NGA,Trinidad and Tobago,TTO,0,0,0,19,0,0,19,0,0,5,142,0,0,147,166
2022,Pakistan,PAK,Trinidad and Tobago,TTO,0,0,0,5,0,0,5,0,0,0,24,0,0,24,29
2022,Peru,PER,Trinidad and Tobago,TTO,0,0,0,7,0,0,7,0,0,0,0,0,0,0,7
2022,Philippines,PHL,Trinidad and Tobago,TTO,0,0,0,0,0,0,0,0,0,0,5,0,0,5,5
2022,Viet Nam,VNM,Trinidad and Tobago,TTO,0,0,0,0,0,0,0,0,0,0,7,0,0,7,7
2022,Syrian Arab Rep.,SYR,Trinidad and Tobago,TTO,0,5,0,11,0,0,16,0,5,0,72,0,0,77,93
2022,Tajikistan,TJK,Trinidad and Tobago,TTO,0,0,0,0,0,0,0,0,0,0,0,6,5,11,11
2022,Saint Vincent and the Grenadines,VCT,Trinidad and Tobago,TTO,0,0,0,10,0,0,10,0,0,0,0,0,0,0,10
2022,Venezuela (Bolivarian Republic of),VEN,Trinidad and Tobago,TTO,360,1249,779,8232,192,0,10812,346,1323,784,7631,240,0,10324,35314
2022,Afghanistan,AFG,Tunisia,TUN,0,5,0,0,0,0,5,0,0,0,0,0,0,0,5
2022,Algeria,DZA,Tunisia,TUN,0,0,0,5,0,0,5,0,0,0,27,0,0,27,32
2022,Egypt,EGY,Tunisia,TUN,0,0,0,5,0,0,5,0,0,0,7,0,0,7,12
2022,Burundi,BDI,Tunisia,TUN,0,0,0,8,0,0,8,0,0,0,0,0,0,0,8
2022,Benin,BEN,Tunisia,TUN,0,0,0,5,0,0,5,0,0,0,5,0,0,5,10
2022,Bangladesh,BGD,Tunisia,TUN,0,0,0,0,0,0,0,0,0,0,5,0,0,5,5
2022,Burkina Faso,BFA,Tunisia,TUN,0,0,0,18,0,0,18,0,0,0,52,0,0,52,70
2022,Central African Rep.,CAF,Tunisia,TUN,0,0,0,9,0,0,9,0,0,5,71,0,0,76,85
2022,Chad,TCD,Tunisia,TUN,0,0,0,0,0,0,0,0,0,8,23,0,0,31,31
2022,Cameroon,CMR,Tunisia,TUN,31,0,5,149,0,0,185,15,10,15,311,0,0,351,536
2022,Congo,COG,Tunisia,TUN,0,0,0,7,0,0,7,0,0,0,0,0,0,0,7
2022,Dem. Rep. of the Congo,COD,Tunisia,TUN,0,0,0,37,0,0,37,6,0,0,82,0,0,88,125
2022,Comoros,COM,Tunisia,TUN,0,0,0,0,0,0,0,5,0,0,0,0,0,5,5
2022,Eritrea,ERI,Tunisia,TUN,0,5,0,13,0,0,18,0,5,38,105,0,0,148,166
2022,Ethiopia,ETH,Tunisia,TUN,0,0,0,0,0,0,0,5,0,8,8,0,0,21,21
2022,Gambia,GMB,Tunisia,TUN,6,0,0,0,0,0,6,0,0,0,6,0,0,6,12
2022,Palestinian,PSE,Tunisia,TUN,0,5,5,17,0,0,27,7,9,0,31,0,0,47,74
2022,Ghana,GHA,Tunisia,TUN,7,0,0,0,0,0,7,0,0,0,0,0,0,0,7
2022,Guinea,GIN,Tunisia,TUN,25,0,0,75,0,0,100,20,0,30,316,0,0,366,466
2022,Cote d'Ivoire,CIV,Tunisia,TUN,157,34,5,1332,5,0,1533,176,28,10,1483,0,0,1697,3230
2022,Iran (Islamic Rep. of),IRN,Tunisia,TUN,0,0,0,0,0,0,0,0,0,0,5,0,0,5,5
2022,Iraq,IRQ,Tunisia,TUN,0,0,0,16,0,0,16,0,0,13,10,0,0,23,39
2022,Liberia,LBR,Tunisia,TUN,10,0,0,5,0,0,15,0,0,5,47,0,0,52,67
2022,Libya,LBY,Tunisia,TUN,0,14,26,46,0,0,86,10,28,10,81,5,0,134,220
2022,Lebanon,LBN,Tunisia,TUN,5,12,0,0,0,0,17,0,0,6,0,0,0,6,23
2022,Mauritania,MRT,Tunisia,TUN,0,0,0,5,0,0,5,0,0,0,5,0,0,5,10
2022,Mali,MLI,Tunisia,TUN,0,5,0,27,0,0,32,0,0,13,96,0,0,109,141
2022,Morocco,MAR,Tunisia,TUN,0,0,0,0,0,0,0,0,0,0,5,0,0,5,5
2022,Niger,NER,Tunisia,TUN,5,0,0,0,0,0,5,0,0,0,5,0,0,5,10
2022,Nigeria,NGA,Tunisia,TUN,11,6,0,15,0,0,32,11,0,0,61,0,0,72,104
2022,Senegal,SEN,Tunisia,TUN,0,0,0,6,0,0,6,0,0,0,19,0,0,19,25
2022,Sierra Leone,SLE,Tunisia,TUN,0,0,5,20,0,0,25,0,0,7,99,0,0,106,131
2022,Somalia,SOM,Tunisia,TUN,5,0,0,12,0,0,17,5,0,28,32,0,0,65,82
2022,South Sudan,SSD,Tunisia,TUN,0,0,0,0,0,0,0,0,0,0,19,0,0,19,19
2022,Sudan,SDN,Tunisia,TUN,5,17,8,13,0,0,43,10,0,60,384,0,0,454,497
2022,Syrian Arab Rep.,SYR,Tunisia,TUN,125,233,159,561,50,0,1128,123,242,169,802,33,0,1369,2497
2022,Togo,TGO,Tunisia,TUN,0,0,0,0,0,0,0,0,0,0,13,0,0,13,13
2022,Ukraine,UKR,Tunisia,TUN,0,5,0,15,9,0,29,0,0,0,0,0,0,0,29
2022,Yemen,YEM,Tunisia,TUN,9,0,5,5,0,0,19,0,10,0,76,0,0,86,105
2022,Afghanistan,AFG,Türkiye,TUR,6472,10213,6313,25309,1186,0,49493,6933,11278,7993,51813,1303,0,79320,139394
2022,Iran (Islamic Rep. of),IRN,Türkiye,TUR,175,489,510,4576,207,0,5957,212,527,555,5629,204,0,7127,18198
2022,Iraq,IRQ,Türkiye,TUR,5776,12649,10010,30732,2418,0,61585,6041,13387,10875,28953,1788,0,61044,134484
2022,Syrian Arab Rep.,SYR,Türkiye,TUR,268310,330634,205516,781379,59151,0,1644990,286939,350580,227039,973061,53289,0,1890908,3535898
2022,Unknown ,UNK,Türkiye,TUR,0,0,0,0,0,0,0,0,0,0,0,0,0,0,7664
2022,Ukraine,UKR,Türkiye,TUR,70,179,152,800,329,0,1530,62,166,145,172,114,0,659,4957
2022,Afghanistan,AFG,United Arab Emirates,ARE,0,5,5,10,0,0,20,0,0,0,9,5,0,14,34
2022,Egypt,EGY,United Arab Emirates,ARE,0,0,0,0,0,0,0,0,0,5,6,0,0,11,11
2022,Eritrea,ERI,United Arab Emirates,ARE,0,0,0,0,0,0,0,0,0,7,0,0,0,7,7
2022,Ethiopia,ETH,United Arab Emirates,ARE,0,0,5,0,0,0,5,0,0,0,0,0,0,0,5
2022,Palestinian,PSE,United Arab Emirates,ARE,0,0,0,7,0,0,7,0,0,5,5,0,0,10,17
2022,Iran (Islamic Rep. of),IRN,United Arab Emirates,ARE,0,0,0,0,0,0,0,0,0,0,12,0,0,12,12
2022,Iraq,IRQ,United Arab Emirates,ARE,5,59,91,432,86,0,673,5,70,99,388,97,0,659,1332
2022,Jordan,JOR,United Arab Emirates,ARE,0,0,0,7,0,0,7,0,0,0,0,0,0,0,7
2022,Kuwait,KWT,United Arab Emirates,ARE,0,0,0,0,0,0,0,0,0,0,5,0,0,5,5
2022,Lebanon,LBN,United Arab Emirates,ARE,0,0,0,13,0,0,13,0,0,0,13,0,0,13,26
2022,Russian Federation,RUS,United Arab Emirates,ARE,0,0,0,0,0,0,0,0,5,0,0,0,0,5,5
2022,Somalia,SOM,United Arab Emirates,ARE,0,0,0,13,0,0,13,0,0,0,7,0,0,7,20
2022,Sudan,SDN,United Arab Emirates,ARE,0,0,0,6,0,0,6,0,0,0,14,0,0,14,20
2022,Syrian Arab Rep.,SYR,United Arab Emirates,ARE,58,721,637,1832,142,0,3390,68,787,634,1903,169,0,3561,6951
2022,Yemen,YEM,United Arab Emirates,ARE,0,0,14,10,0,0,24,0,0,7,26,0,0,33,57
2022,Afghanistan,AFG,Uganda,UGA,0,0,5,10,0,0,15,0,5,0,13,0,0,18,33
2022,Egypt,EGY,Uganda,UGA,0,0,0,0,0,0,0,0,0,0,8,0,0,8,8
2022,Burundi,BDI,Uganda,UGA,3730,4249,2705,8624,518,0,19826,3522,4225,2837,9782,441,0,20807,40633
2022,Central African Rep.,CAF,Uganda,UGA,0,7,6,5,0,0,18,0,8,0,9,0,0,17,35
2022,Chad,TCD,Uganda,UGA,0,0,0,9,0,0,9,0,0,0,5,0,0,5,14
2022,Cameroon,CMR,Uganda,UGA,0,0,0,8,0,0,8,0,0,0,5,0,0,5,13
2022,Congo,COG,Uganda,UGA,0,13,5,0,0,0,18,8,0,5,5,0,0,18,36
2022,Dem. Rep. of the Congo,COD,Uganda,UGA,46024,56960,35517,101755,6855,0,247111,45973,56894,36206,87636,5544,0,232253,479364
2022,Eritrea,ERI,Uganda,UGA,1249,1758,832,10228,111,0,14178,1351,1858,955,8147,194,0,12505,26683
2022,Ethiopia,ETH,Uganda,UGA,154,278,199,1638,21,0,2290,183,308,179,2342,28,0,3040,5330
2022,Palestinian,PSE,Uganda,UGA,0,0,0,0,0,0,0,0,0,0,5,0,0,5,5
2022,Iran (Islamic Rep. of),IRN,Uganda,UGA,0,0,0,0,0,0,0,0,0,0,5,0,0,5,5
2022,Kenya,KEN,Uganda,UGA,29,8,20,61,5,0,123,18,25,17,60,10,0,130,253
2022,Mali,MLI,Uganda,UGA,0,0,0,0,0,0,0,0,0,5,0,0,0,5,5
2022,Pakistan,PAK,Uganda,UGA,12,20,9,44,0,0,85,14,26,14,97,5,0,156,241
2022,Rwanda,RWA,Uganda,UGA,1804,2268,1961,5537,465,0,12035,1861,2278,1931,4557,589,0,11216,23251
2022,Senegal,SEN,Uganda,UGA,0,0,0,0,0,0,0,0,7,0,0,0,0,7,7
2022,Somalia,SOM,Uganda,UGA,1578,3202,3335,17605,572,0,26292,1649,3300,3362,26661,299,0,35271,61563
2022,South Sudan,SSD,Uganda,UGA,70349,107460,81212,174339,16079,0,449439,70336,111119,92517,124018,6841,0,404831,854270
2022,Sudan,SDN,Uganda,UGA,179,283,257,735,25,0,1479,191,328,256,1456,42,0,2273,3752
2022,Syrian Arab Rep.,SYR,Uganda,UGA,0,0,0,0,0,0,0,0,0,5,28,0,0,33,33
2022,United Rep. of Tanzania,TZA,Uganda,UGA,0,7,0,10,0,0,17,0,0,5,0,0,0,5,22
2022,Türkiye,TUR,Uganda,UGA,0,8,7,21,0,0,36,0,7,7,35,0,0,49,85
2022,Yemen,YEM,Uganda,UGA,0,0,5,18,0,0,23,0,14,0,11,0,0,25,48
2022,Afghanistan,AFG,Ukraine,UKR,0,0,65,244,0,0,309,0,0,52,681,18,0,751,1060
2022,Algeria,DZA,Ukraine,UKR,0,0,0,0,0,0,0,0,0,0,5,0,0,5,5
2022,Angola,AGO,Ukraine,UKR,0,0,0,11,0,0,11,0,0,0,15,0,0,15,26
2022,Egypt,EGY,Ukraine,UKR,0,0,0,0,0,0,0,0,0,0,7,0,0,7,7
2022,Armenia,ARM,Ukraine,UKR,0,0,0,20,0,0,20,0,0,0,25,0,0,25,45
2022,Azerbaijan,AZE,Ukraine,UKR,0,0,0,15,5,0,20,0,0,0,34,7,0,41,61
2022,Burundi,BDI,Ukraine,UKR,0,0,0,0,0,0,0,0,0,0,5,0,0,5,5
2022,Bangladesh,BGD,Ukraine,UKR,0,0,0,0,0,0,0,0,0,0,16,0,0,16,16
2022,Belarus,BLR,Ukraine,UKR,0,0,0,11,0,6,17,0,0,0,31,0,25,56,73
2022,Cameroon,CMR,Ukraine,UKR,0,0,0,0,0,0,0,0,0,0,14,0,0,14,14
2022,Congo,COG,Ukraine,UKR,0,0,0,5,0,0,5,0,0,0,28,0,0,28,33
2022,Dem. Rep. of the Congo,COD,Ukraine,UKR,0,0,0,7,0,0,7,0,0,0,5,0,5,10,17
2022,Eritrea,ERI,Ukraine,UKR,0,0,0,5,0,0,5,0,0,0,11,0,0,11,16
2022,Ethiopia,ETH,Ukraine,UKR,0,0,0,5,0,0,5,0,0,0,18,0,0,18,23
2022,Palestinian,PSE,Ukraine,UKR,0,0,0,0,0,0,0,0,0,0,35,0,0,35,35
2022,Georgia,GEO,Ukraine,UKR,0,0,0,11,0,0,11,0,0,0,14,0,0,14,25
2022,Ghana,GHA,Ukraine,UKR,0,0,0,0,0,0,0,0,0,0,5,0,0,5,5
2022,Guinea,GIN,Ukraine,UKR,0,0,0,5,0,0,5,0,0,0,0,0,0,0,5
2022,Cote d'Ivoire,CIV,Ukraine,UKR,0,0,0,0,0,0,0,0,0,0,10,0,0,10,10
2022,India,IND,Ukraine,UKR,0,0,0,0,0,0,0,0,0,0,19,0,0,19,19
2022,Iran (Islamic Rep. of),IRN,Ukraine,UKR,0,0,0,14,0,0,14,0,0,0,60,6,0,66,80
2022,Iraq,IRQ,Ukraine,UKR,0,0,0,31,0,0,31,0,0,5,62,5,0,72,103
2022,Kazakhstan,KAZ,Ukraine,UKR,0,0,0,7,0,0,7,0,0,0,15,0,0,15,22
2022,Kyrgyzstan,KGZ,Ukraine,UKR,0,0,0,17,0,0,17,0,0,0,16,0,0,16,33
2022,Libya,LBY,Ukraine,UKR,0,0,5,0,0,0,5,0,0,5,0,0,0,5,10
2022,Lebanon,LBN,Ukraine,UKR,0,0,0,0,0,0,0,0,0,0,11,0,0,11,11
2022,Sri Lanka,LKA,Ukraine,UKR,0,0,0,0,0,0,0,0,0,0,32,0,0,32,32
2022,Rep. of Moldova,MDA,Ukraine,UKR,0,0,0,0,0,0,0,0,0,0,5,0,0,5,5
2022,Morocco,MAR,Ukraine,UKR,0,0,0,0,0,0,0,0,0,0,8,0,0,8,8
2022,Nigeria,NGA,Ukraine,UKR,0,0,0,0,0,0,0,0,0,0,10,0,0,10,10
2022,Pakistan,PAK,Ukraine,UKR,0,0,0,9,0,0,9,0,0,0,22,0,0,22,31
2022,Russian Federation,RUS,Ukraine,UKR,0,0,0,90,5,0,95,0,0,0,174,5,0,179,274
2022,Senegal,SEN,Ukraine,UKR,0,0,0,0,0,0,0,0,0,0,5,0,0,5,5
2022,Sierra Leone,SLE,Ukraine,UKR,0,0,0,0,0,0,0,0,0,0,5,0,0,5,5
2022,Somalia,SOM,Ukraine,UKR,0,0,6,25,0,0,31,0,0,8,63,0,0,71,102
2022,Serbia and Kosovo: S/RES/1244 (1999),SRB,Ukraine,UKR,0,0,5,0,0,0,5,0,0,0,0,0,0,0,5
2022,Viet Nam,VNM,Ukraine,UKR,0,0,0,0,0,0,0,0,0,0,19,0,0,19,19
2022,Stateless,XXA,Ukraine,UKR,0,0,0,26,0,0,26,0,0,0,42,5,0,47,73
2022,Sudan,SDN,Ukraine,UKR,0,0,0,0,0,0,0,0,0,0,27,0,0,27,27
2022,Syrian Arab Rep.,SYR,Ukraine,UKR,0,0,19,77,0,0,96,0,0,13,424,0,0,437,533
2022,Tajikistan,TJK,Ukraine,UKR,0,0,0,27,0,0,27,0,0,0,27,0,0,27,54
2022,Turkmenistan,TKM,Ukraine,UKR,0,0,0,0,0,0,0,0,0,0,6,0,0,6,6
2022,Türkiye,TUR,Ukraine,UKR,0,0,0,0,0,0,0,0,0,0,13,0,0,13,13
2022,Uzbekistan,UZB,Ukraine,UKR,0,0,0,21,0,0,21,0,0,0,30,0,0,30,51
2022,Yemen,YEM,Ukraine,UKR,0,0,0,0,0,0,0,0,0,0,10,0,0,10,10
2022,Afghanistan,AFG,Uruguay,URY,0,0,0,0,0,0,0,0,0,0,6,0,0,6,6
2022,Angola,AGO,Uruguay,URY,0,7,0,0,0,0,7,0,0,7,0,0,0,7,14
2022,Egypt,EGY,Uruguay,URY,0,0,0,0,0,0,0,0,0,0,7,0,0,7,7
2022,Argentina,ARG,Uruguay,URY,5,0,0,0,0,0,5,0,0,0,6,0,0,6,11
2022,Bangladesh,BGD,Uruguay,URY,0,0,0,0,0,0,0,0,0,0,139,0,0,139,139
2022,Bolivia (Plurinational State of),BOL,Uruguay,URY,0,0,0,7,0,0,7,0,0,6,0,0,0,6,13
2022,Brazil,BRA,Uruguay,URY,7,0,0,5,0,0,12,7,0,0,8,0,0,15,27
2022,Chile,CHL,Uruguay,URY,0,0,0,0,0,0,0,7,0,0,0,0,0,7,7
2022,Cameroon,CMR,Uruguay,URY,0,0,0,5,0,0,5,0,0,0,13,0,0,13,18
2022,Congo,COG,Uruguay,URY,0,0,0,0,0,0,0,0,0,0,5,0,0,5,5
2022,Colombia,COL,Uruguay,URY,7,5,8,98,8,0,126,14,7,5,136,12,0,174,300
2022,Cuba,CUB,Uruguay,URY,113,234,158,4177,107,0,4789,111,269,189,6677,105,0,7351,12140
2022,Dominican Rep.,DOM,Uruguay,URY,9,7,5,334,5,0,360,7,11,8,308,0,0,334,694
2022,Ecuador,ECU,Uruguay,URY,9,0,8,5,0,0,22,12,0,0,8,0,0,20,42
2022,Ghana,GHA,Uruguay,URY,0,0,0,0,0,0,0,0,0,0,21,0,0,21,21
2022,Guinea-Bissau,GNB,Uruguay,URY,0,0,0,0,0,0,0,0,0,0,5,0,0,5,5
2022,Guatemala,GTM,Uruguay,URY,0,0,5,0,0,0,5,0,0,0,0,0,0,0,5
2022,Guinea,GIN,Uruguay,URY,0,0,0,0,0,0,0,0,0,0,6,0,0,6,11
2022,Haiti,HTI,Uruguay,URY,0,5,0,5,0,0,10,0,0,0,17,0,0,17,27
2022,India,IND,Uruguay,URY,0,0,0,0,0,0,0,0,0,0,6,0,0,6,6
2022,Libya,LBY,Uruguay,URY,0,0,0,5,0,0,5,0,0,0,0,0,0,0,5
2022,Latvia,LVA,Uruguay,URY,0,0,0,0,0,0,0,0,0,0,5,0,0,5,5
2022,Mauritania,MRT,Uruguay,URY,0,0,0,0,0,0,0,0,0,0,5,0,0,5,5
2022,Mexico,MEX,Uruguay,URY,0,8,0,0,0,0,8,0,0,0,0,0,0,0,8
2022,Morocco,MAR,Uruguay,URY,0,0,0,0,0,0,0,0,0,0,32,0,0,32,32
2022,Nicaragua,NIC,Uruguay,URY,0,0,0,0,0,0,0,0,0,0,14,0,0,14,14
2022,Nigeria,NGA,Uruguay,URY,0,0,0,5,0,0,5,0,0,0,51,0,0,51,56
2022,Pakistan,PAK,Uruguay,URY,0,0,0,0,0,0,0,0,0,0,29,0,0,29,29
2022,Paraguay,PRY,Uruguay,URY,5,0,0,0,0,0,5,0,0,0,5,0,0,5,10
2022,Peru,PER,Uruguay,URY,26,0,0,7,0,0,33,24,0,0,15,0,0,39,72
2022,South Africa,ZAF,Uruguay,URY,0,0,0,0,0,0,0,0,0,0,5,0,0,5,5
2022,Russian Federation,RUS,Uruguay,URY,0,0,0,0,0,0,0,0,0,0,16,6,0,22,22
2022,El Salvador,SLV,Uruguay,URY,0,0,0,17,0,0,17,0,8,0,29,0,0,37,54
2022,Senegal,SEN,Uruguay,URY,0,0,0,5,0,0,5,0,0,0,190,0,0,190,195
2022,Somalia,SOM,Uruguay,URY,0,0,0,5,0,0,5,0,0,0,0,0,0,0,5
2022,Syrian Arab Rep.,SYR,Uruguay,URY,0,0,10,19,0,0,29,5,0,6,32,0,0,43,72
2022,Türkiye,TUR,Uruguay,URY,0,6,0,0,0,0,6,0,0,0,12,0,0,12,18
2022,Ukraine,UKR,Uruguay,URY,0,0,0,6,5,0,11,0,0,0,0,7,0,7,18
2022,Venezuela (Bolivarian Republic of),VEN,Uruguay,URY,60,245,128,1092,75,13732,15332,66,233,121,1411,40,9291,11162,26494
2022,Aruba,ABW,United States of America,USA,0,0,0,0,0,0,0,0,0,0,0,0,0,0,7
2022,Afghanistan,AFG,United States of America,USA,0,5,5,77,0,0,87,0,15,0,204,5,5,229,21764
2022,Albania,ALB,United States of America,USA,0,23,34,322,7,26,412,0,19,29,453,18,66,585,4103
2022,Algeria,DZA,United States of America,USA,0,0,6,36,0,0,42,0,11,5,75,0,0,91,706
2022,Angola,AGO,United States of America,USA,19,146,138,433,0,32,768,18,140,103,521,7,22,811,4733
2022,Antigua and Barbuda,ATG,United States of America,USA,0,0,0,0,0,0,0,0,0,0,8,0,0,8,26
2022,Egypt,EGY,United States of America,USA,0,59,111,557,15,15,757,0,55,153,801,51,48,1108,22981
2022,Argentina,ARG,United States of America,USA,38,16,5,45,5,0,109,14,28,0,68,5,5,120,769
2022,Armenia,ARM,United States of America,USA,30,73,82,655,39,55,934,24,119,117,976,33,87,1356,10021
2022,Australia,AUS,United States of America,USA,0,0,0,0,0,0,0,0,0,0,0,0,0,0,8
2022,Austria,AUT,United States of America,USA,0,0,0,0,0,0,0,0,0,0,0,0,0,0,30
2022,Azerbaijan,AZE,United States of America,USA,0,7,18,92,0,0,117,0,15,18,138,0,5,176,2526
2022,Bahrain,BHR,United States of America,USA,0,0,0,0,0,0,0,0,0,0,0,0,0,0,81
2022,Barbados,BRB,United States of America,USA,0,0,0,5,0,0,5,0,0,0,0,0,0,0,5
2022,Burundi,BDI,United States of America,USA,0,0,11,103,0,10,124,0,0,5,132,5,10,152,1612
2022,Belgium,BEL,United States of America,USA,0,7,0,0,0,0,7,0,0,0,6,0,0,6,60
2022,Benin,BEN,United States of America,USA,0,0,0,25,0,0,25,0,5,0,44,0,0,49,410
2022,Bangladesh,BGD,United States of America,USA,8,33,73,442,0,19,575,16,31,87,2618,36,763,3551,15039
2022,Bahamas,BHS,United States of America,USA,0,9,0,12,0,0,21,0,0,8,28,0,0,36,593
2022,Bhutan,BTN,United States of America,USA,0,0,0,5,0,0,5,0,0,0,12,0,0,12,440
2022,Burkina Faso,BFA,United States of America,USA,0,6,17,337,0,5,365,5,10,11,559,5,23,613,4669
2022,Belarus,BLR,United States of America,USA,0,0,0,0,0,0,0,0,0,0,0,0,0,0,6119
2022,Bolivia (Plurinational State of),BOL,United States of America,USA,0,19,5,101,0,11,136,5,14,5,126,0,14,164,1434
2022,Botswana,BWA,United States of America,USA,0,0,0,0,0,0,0,0,0,0,0,0,0,0,24
2022,Brazil,BRA,United States of America,USA,1014,1830,1043,7160,11,550,11608,1056,1947,1073,7259,47,445,11827,41017
2022,Bosnia and Herzegovina,BIH,United States of America,USA,0,0,0,20,0,0,20,0,0,0,46,0,0,46,320
2022,Bulgaria,BGR,United States of America,USA,0,0,0,41,0,6,47,0,0,0,47,0,0,47,449
2022,Belize,BLZ,United States of America,USA,5,18,10,61,0,0,94,0,32,10,51,0,0,93,438
2022,Cambodia,KHM,United States of America,USA,0,0,0,16,0,0,16,0,5,0,5,0,5,15,200
2022,Canada,CAN,United States of America,USA,0,11,5,12,0,0,28,0,10,0,0,0,0,10,161
2022,Central African Rep.,CAF,United States of America,USA,0,0,0,13,0,0,13,0,5,0,22,0,0,27,313
2022,Cayman Islands,CYM,United States of America,USA,0,0,0,0,0,0,0,0,0,0,0,0,0,0,5
2022,Chad,TCD,United States of America,USA,0,0,5,10,0,0,15,0,5,0,71,0,0,76,519
2022,China,CHN,United States of America,USA,0,155,225,5867,392,547,7186,18,178,218,7628,269,1025,9336,152620
2022,Chile,CHL,United States of America,USA,607,127,0,28,0,17,779,599,116,0,35,0,23,773,2937
2022,Cameroon,CMR,United States of America,USA,0,24,0,726,18,172,940,5,19,0,1069,0,404,1497,11099
2022,Congo,COG,United States of America,USA,5,34,27,258,5,18,347,6,33,23,310,5,16,393,2737
2022,Dem. Rep. of the Congo,COD,United States of America,USA,0,0,0,0,0,0,0,0,0,0,0,0,0,0,5830
2022,Comoros,COM,United States of America,USA,0,0,0,0,0,0,0,0,0,0,0,0,0,0,10
2022,Colombia,COL,United States of America,USA,282,695,588,4356,119,271,6311,268,663,585,4729,144,280,6669,71803
2022,Costa Rica,CRI,United States of America,USA,30,12,5,112,0,0,159,11,26,0,167,7,10,221,1083
2022,Cuba,CUB,United States of America,USA,376,908,602,16872,394,910,20062,359,953,690,20912,408,1774,25096,171716
2022,Curacao ,CUW,United States of America,USA,0,0,0,0,0,0,0,0,0,0,0,0,0,0,40
2022,Cabo Verde,CPV,United States of America,USA,0,0,0,15,0,0,15,0,0,0,9,0,0,9,57
2022,Cyprus,CYP,United States of America,USA,0,0,0,7,0,0,7,0,0,0,0,0,0,0,7
2022,Czechia,CZE,United States of America,USA,0,0,0,5,0,0,5,0,0,0,0,0,0,0,69
2022,Denmark,DNK,United States of America,USA,0,0,0,0,0,0,0,0,5,0,0,0,0,5,13
2022,Djibouti,DJI,United States of America,USA,0,0,5,31,0,5,41,0,5,0,45,0,0,50,986
2022,Dominica,DMA,United States of America,USA,0,0,0,7,0,0,7,0,0,0,0,0,0,0,58
2022,Dominican Rep.,DOM,United States of America,USA,0,10,7,207,5,21,250,0,5,5,328,5,47,390,2288
2022,Ecuador,ECU,United States of America,USA,593,1331,638,6374,25,587,9548,596,1350,740,5495,47,665,8893,39900
2022,Equatorial Guinea,GNQ,United States of America,USA,0,0,0,6,0,0,6,0,7,5,16,0,0,28,126
2022,Eritrea,ERI,United States of America,USA,0,10,6,143,0,28,187,0,5,12,682,5,214,918,6450
2022,Estonia,EST,United States of America,USA,0,0,0,0,0,0,0,0,0,0,0,0,0,0,81
2022,Ethiopia,ETH,United States of America,USA,0,17,36,486,23,21,583,0,22,21,669,19,99,830,17625
2022,French Guiana,GUF,United States of America,USA,0,0,0,0,0,0,0,0,7,0,0,0,0,7,13
2022,Fiji,FJI,United States of America,USA,0,0,0,14,0,0,14,0,0,0,17,0,0,17,596
2022,Finland,FIN,United States of America,USA,0,0,0,0,0,0,0,0,0,0,0,0,0,0,5
2022,France,FRA,United States of America,USA,0,9,5,8,0,0,22,11,7,0,5,0,0,23,217
2022,Micronesia (Federated States of),FSM,United States of America,USA,0,0,0,0,0,0,0,0,0,0,0,0,0,0,5
2022,Gabon,GAB,United States of America,USA,0,5,0,31,0,0,36,0,5,5,22,0,0,32,457
2022,Gambia,GMB,United States of America,USA,0,0,0,150,5,0,155,0,0,5,138,5,27,175,2013
2022,Palestinian,PSE,United States of America,USA,0,5,0,15,0,0,20,0,0,17,66,0,0,83,350
2022,United Kingdom of Great Britain and Northern Ireland,GBR,United States of America,USA,0,5,5,16,0,5,31,0,0,0,14,0,0,14,215
2022,Georgia,GEO,United States of America,USA,5,26,15,351,15,25,437,6,19,20,981,5,82,1113,5411
2022,Germany,DEU,United States of America,USA,0,0,0,7,0,0,7,0,5,0,20,0,0,25,442
2022,Ghana,GHA,United States of America,USA,23,27,5,181,6,25,267,15,11,13,435,10,121,605,2474
2022,Guadeloupe,GLP,United States of America,USA,0,6,0,21,0,0,27,0,7,0,9,0,0,16,140
2022,Guinea-Bissau,GNB,United States of America,USA,0,0,0,5,0,0,5,0,0,0,15,0,0,15,84
2022,Greece,GRC,United States of America,USA,0,0,5,5,0,0,10,0,0,0,10,0,0,10,105
2022,Grenada,GRD,United States of America,USA,0,0,0,0,0,0,0,0,0,0,0,0,0,0,48
2022,Guatemala,GTM,United States of America,USA,1050,6338,3921,26455,103,3645,41512,996,6838,4846,25060,165,2231,40136,182665
2022,Guinea,GIN,United States of America,USA,0,6,0,200,0,24,230,10,0,6,337,11,77,441,2920
2022,Guyana,GUY,United States of America,USA,5,9,0,29,0,0,43,0,8,5,42,0,5,60,643
2022,Haiti,HTI,United States of America,USA,143,375,234,5090,50,174,6066,137,324,252,6591,88,295,7687,88835
2022,"China, Hong Kong SAR",HKG,United States of America,USA,0,0,0,11,0,0,11,0,0,0,6,0,0,6,281
2022,Honduras,HND,United States of America,USA,1406,6175,4049,25123,89,4077,40919,1464,6561,4501,17260,98,2340,32224,148099
2022,Croatia,HRV,United States of America,USA,0,0,0,7,0,0,7,0,0,0,13,0,0,13,74
2022,Hungary,HUN,United States of America,USA,0,0,0,37,0,0,37,0,0,5,46,0,0,51,460
2022,Iceland,ISL,United States of America,USA,0,0,0,0,0,0,0,0,0,0,0,0,0,0,5
2022,Cote d'Ivoire,CIV,United States of America,USA,0,0,5,203,0,0,208,0,15,0,184,5,5,209,2449
2022,India,IND,United States of America,USA,94,272,218,2465,36,117,3202,132,345,343,16416,96,2067,19399,72884
2022,Indonesia,IDN,United States of America,USA,0,14,9,267,28,0,318,0,10,16,307,6,0,339,4429
2022,Ireland,IRL,United States of America,USA,0,0,0,0,0,0,0,0,5,5,0,0,0,10,66
2022,Iran (Islamic Rep. of),IRN,United States of America,USA,0,8,20,284,12,10,334,0,11,24,368,24,23,450,8833
2022,Iraq,IRQ,United States of America,USA,0,32,65,381,81,19,578,0,43,73,550,56,57,779,9433
2022,Israel,ISR,United States of America,USA,0,0,5,15,0,0,20,0,0,5,45,0,0,50,683
2022,Italy,ITA,United States of America,USA,0,0,24,10,5,7,46,0,6,14,18,0,12,50,421
2022,Jamaica,JAM,United States of America,USA,0,11,0,177,10,0,198,0,0,16,273,12,18,319,3106
2022,Jordan,JOR,United States of America,USA,0,18,61,211,0,5,295,0,53,46,401,10,10,520,4043
2022,Japan,JPN,United States of America,USA,0,0,0,11,0,0,11,0,5,0,9,0,0,14,106
2022,Kazakhstan,KAZ,United States of America,USA,0,35,22,273,15,5,350,5,33,22,312,5,10,387,6167
2022,Kenya,KEN,United States of America,USA,0,5,12,250,21,11,299,0,0,16,212,5,5,238,9030
2022,Kyrgyzstan,KGZ,United States of America,USA,5,25,23,325,0,10,388,10,27,33,481,5,23,579,5103
2022,Rep. of Korea,KOR,United States of America,USA,0,0,0,59,0,0,59,0,0,0,16,0,0,16,229
2022,Dem. People's Rep. of Korea,PRK,United States of America,USA,0,0,0,10,0,0,10,0,0,0,0,0,0,0,70
2022,Kuwait,KWT,United States of America,USA,0,0,0,22,0,0,22,0,0,0,25,0,0,25,1022
2022,Lao People's Dem. Rep.,LAO,United States of America,USA,0,0,0,7,10,0,17,0,0,0,17,5,0,22,246
2022,Liberia,LBR,United States of America,USA,0,5,5,140,5,0,155,0,10,5,92,10,0,117,2275
2022,Libya,LBY,United States of America,USA,0,5,8,70,0,0,83,0,0,20,141,0,5,166,2352
2022,Saint Lucia,LCA,United States of America,USA,0,0,0,6,0,0,6,0,0,0,6,0,0,6,23
2022,Lebanon,LBN,United States of America,USA,0,9,5,113,0,7,134,0,16,27,214,0,12,269,2619
2022,Lesotho,LSO,United States of America,USA,0,0,0,0,0,0,0,0,0,0,0,0,0,0,7
2022,Sri Lanka,LKA,United States of America,USA,0,0,0,81,0,5,86,0,0,0,343,10,54,407,3327
2022,Lithuania,LTU,United States of America,USA,0,0,0,13,0,0,13,0,0,0,10,0,0,10,96
2022,Latvia,LVA,United States of America,USA,0,0,0,19,0,0,19,0,0,0,5,0,0,5,150
2022,"China, Macao SAR",MAC,United States of America,USA,0,0,0,0,0,0,0,0,0,5,0,0,0,5,20
2022,Madagascar,MDG,United States of America,USA,0,0,0,5,0,0,5,0,0,0,0,0,0,0,39
2022,Mauritania,MRT,United States of America,USA,0,0,9,46,0,0,55,0,0,14,309,5,31,359,2124
2022,North Macedonia,MKD,United States of America,USA,0,0,0,14,0,0,14,0,0,0,68,0,0,68,334
2022,Rep. of Moldova,MDA,United States of America,USA,0,18,10,296,0,12,336,0,12,5,353,0,14,384,4290
2022,Maldives,MDV,United States of America,USA,0,0,0,0,0,0,0,0,0,0,0,0,0,0,10
2022,Mexico,MEX,United States of America,USA,666,2886,2005,18254,318,854,24983,692,3058,2185,17878,441,1106,25360,119282
2022,Mali,MLI,United States of America,USA,0,12,0,161,0,5,178,5,5,0,135,5,6,156,1479
2022,Malaysia,MYS,United States of America,USA,0,5,5,35,0,0,45,0,0,0,25,0,0,25,429
2022,Malawi,MWI,United States of America,USA,0,5,0,22,0,0,27,0,0,5,19,0,0,24,249
2022,Montenegro,MNE,United States of America,USA,0,0,0,49,0,0,49,0,0,5,96,0,0,101,670
2022,Mongolia,MNG,United States of America,USA,0,13,16,213,0,18,260,0,12,18,215,5,5,255,4190
2022,Morocco,MAR,United States of America,USA,0,0,0,15,0,0,15,0,0,5,43,0,0,48,445
2022,Mozambique,MOZ,United States of America,USA,0,0,11,0,0,0,11,0,0,0,5,0,0,5,89
2022,Malta,MLT,United States of America,USA,0,0,0,0,0,0,0,0,0,0,0,0,0,0,5
2022,Mauritius,MUS,United States of America,USA,0,0,0,0,0,0,0,0,0,0,0,0,0,0,83
2022,Myanmar,MMR,United States of America,USA,0,0,0,79,0,0,79,0,0,15,186,0,0,201,5095
2022,Namibia,NAM,United States of America,USA,0,5,5,5,0,0,15,0,0,7,0,0,0,7,97
2022,Nepal,NPL,United States of America,USA,0,0,10,241,0,15,266,0,18,0,1250,15,245,1528,14420
2022,Netherlands (Kingdom of the),NLD,United States of America,USA,0,0,9,23,0,0,32,0,0,0,10,0,0,10,81
2022,Niger,NER,United States of America,USA,0,0,0,0,0,0,0,0,0,0,0,0,0,0,490
2022,Nicaragua,NIC,United States of America,USA,361,997,526,6084,21,544,8533,421,1045,681,8860,22,1219,12248,42097
2022,Nigeria,NGA,United States of America,USA,0,559,496,2426,101,38,3620,0,605,558,1830,95,107,3195,31175
2022,Niue,NIU,United States of America,USA,0,0,0,0,0,0,0,0,0,0,0,0,0,0,18
2022,Oman,OMN,United States of America,USA,0,0,0,0,0,0,0,0,0,7,0,0,0,7,54
2022,Pakistan,PAK,United States of America,USA,0,29,58,443,10,21,561,0,38,86,962,50,111,1247,14007
2022,Panama,PAN,United States of America,USA,119,32,5,17,0,0,173,70,30,0,35,0,5,140,523
2022,Paraguay,PRY,United States of America,USA,0,0,0,21,0,0,21,0,0,8,17,0,0,25,149
2022,Peru,PER,United States of America,USA,129,214,167,1286,26,93,1915,125,222,149,1364,32,129,2021,8899
2022,Philippines,PHL,United States of America,USA,0,5,5,178,31,5,224,0,0,0,160,36,5,201,1689
2022,Poland,POL,United States of America,USA,0,0,0,138,0,5,143,0,0,0,138,0,0,138,867
2022,Portugal,PRT,United States of America,USA,6,0,0,23,0,23,52,0,8,0,24,0,7,39,235
2022,Qatar,QAT,United States of America,USA,0,0,0,0,0,0,0,0,5,0,5,0,0,10,123
2022,Romania,ROU,United States of America,USA,63,173,154,689,0,47,1126,72,203,177,808,0,46,1306,5535
2022,South Africa,ZAF,United States of America,USA,0,26,22,123,15,5,191,0,15,38,95,20,7,175,1351
2022,Russian Federation,RUS,United States of America,USA,270,642,323,2915,74,108,4332,261,655,397,4010,45,192,5560,46041
2022,Rwanda,RWA,United States of America,USA,0,0,19,141,7,0,167,0,0,13,188,5,5,211,2368
2022,El Salvador,SLV,United States of America,USA,742,4433,3476,22922,118,4744,36435,711,4708,3905,16548,115,2918,28905,154918
2022,Saudi Arabia,SAU,United States of America,USA,0,0,10,42,0,0,52,0,0,14,92,0,0,106,2600
2022,Senegal,SEN,United States of America,USA,0,0,0,118,5,5,128,0,0,0,646,11,80,737,1944
2022,Seychelles,SYC,United States of America,USA,0,0,0,0,0,0,0,0,0,0,0,0,0,0,5
2022,Singapore,SGP,United States of America,USA,0,0,0,0,0,0,0,0,0,0,5,0,0,5,70
2022,Sierra Leone,SLE,United States of America,USA,0,0,6,85,0,10,101,0,5,5,76,0,16,102,1052
2022,Somalia,SOM,United States of America,USA,0,0,0,72,0,18,90,0,0,0,423,0,122,545,2327
2022,Spain,ESP,United States of America,USA,5,10,12,17,0,0,44,5,17,0,31,0,5,58,252
2022,Serbia and Kosovo: S/RES/1244 (1999),SRB,United States of America,USA,0,5,0,110,0,0,115,0,9,0,289,0,13,311,2764
2022,Viet Nam,VNM,United States of America,USA,5,52,37,251,0,10,355,5,67,44,269,0,21,406,2086
2022,South Sudan,SSD,United States of America,USA,0,0,0,9,0,0,9,0,0,0,15,0,0,15,143
2022,Saint Kitts and Nevis,KNA,United States of America,USA,0,0,0,0,0,0,0,0,0,0,0,0,0,0,10
2022,Sao Tome and Principe,STP,United States of America,USA,0,0,0,0,0,0,0,0,0,0,0,0,0,0,5
2022,Sudan,SDN,United States of America,USA,0,0,37,58,0,5,100,0,5,17,175,5,7,209,2550
2022,Suriname,SUR,United States of America,USA,0,0,0,0,0,0,0,0,0,0,7,0,0,7,70
2022,Slovakia,SVK,United States of America,USA,0,0,0,0,0,0,0,0,5,0,7,0,0,12,36
2022,Slovenia,SVN,United States of America,USA,0,0,0,0,0,0,0,0,0,0,5,0,0,5,13
2022,Eswatini,SWZ,United States of America,USA,0,0,0,0,0,0,0,0,0,0,0,0,0,0,18
2022,Sweden,SWE,United States of America,USA,0,6,0,0,0,0,6,0,0,0,0,0,0,0,34
2022,Switzerland,CHE,United States of America,USA,0,0,0,0,0,0,0,0,0,0,0,0,0,0,22
2022,Syrian Arab Rep.,SYR,United States of America,USA,0,5,49,264,20,5,343,0,23,41,475,25,52,616,11944
2022,United Rep. of Tanzania,TZA,United States of America,USA,0,0,0,25,0,0,25,0,0,0,20,0,0,20,523
2022,Turks and Caicos Islands,TCA,United States of America,USA,0,0,0,5,0,0,5,0,0,0,0,0,0,0,19
2022,Thailand,THA,United States of America,USA,0,0,0,45,0,0,45,0,0,0,17,5,0,22,530
2022,Tajikistan,TJK,United States of America,USA,0,15,5,51,0,0,71,0,5,18,163,0,13,199,1773
2022,Turkmenistan,TKM,United States of America,USA,0,0,0,12,0,0,12,0,0,11,30,0,0,41,745
2022,Timor-Leste,TLS,United States of America,USA,0,0,0,0,0,0,0,0,0,0,0,0,0,0,17
2022,Togo,TGO,United States of America,USA,0,0,5,69,5,0,79,0,6,5,159,5,22,197,1314
2022,Trinidad and Tobago,TTO,United States of America,USA,0,0,0,28,5,0,33,5,0,0,37,0,0,42,300
2022,Tunisia,TUN,United States of America,USA,0,0,0,22,0,0,22,0,0,13,44,5,0,62,573
2022,Türkiye,TUR,United States of America,USA,5,56,46,349,0,5,461,14,77,62,2018,10,206,2387,15931
2022,United Arab Emirates,ARE,United States of America,USA,0,5,10,21,0,0,36,0,0,18,12,0,0,30,618
2022,Uganda,UGA,United States of America,USA,0,5,15,338,10,10,378,0,11,12,376,0,7,406,5661
2022,Unknown ,UNK,United States of America,USA,29,198,127,1250,36,56,1696,32,209,107,1636,40,100,2124,14928
2022,Ukraine,UKR,United States of America,USA,43,100,97,961,27,46,1274,39,115,105,1139,11,51,1460,15432
2022,Uruguay,URY,United States of America,USA,28,0,0,28,0,0,56,37,0,0,22,0,0,59,317
2022,Uzbekistan,UZB,United States of America,USA,44,78,99,394,7,35,657,42,116,92,1023,5,117,1395,8173
2022,Vanuatu,VUT,United States of America,USA,0,7,6,9,0,0,22,0,5,0,0,0,0,5,62
2022,Holy See,VAT,United States of America,USA,0,0,0,0,0,0,0,0,0,0,0,0,0,0,5
2022,Saint Vincent and the Grenadines,VCT,United States of America,USA,0,0,0,0,0,0,0,0,0,0,5,0,0,5,50
2022,Venezuela (Bolivarian Republic of),VEN,United States of America,USA,1046,3759,2615,24122,1762,1427,34731,1070,3796,2833,24505,1160,1680,35044,393969
2022,Samoa,WSM,United States of America,USA,0,0,0,0,0,0,0,0,0,0,0,0,0,0,5
2022,Western Sahara,ESH,United States of America,USA,0,0,0,0,0,0,0,0,0,0,0,0,0,0,5
2022,Yemen,YEM,United States of America,USA,0,8,0,46,5,0,59,0,5,7,160,0,15,187,1730
2022,Zambia,ZMB,United States of America,USA,0,0,0,16,0,0,16,0,0,0,14,0,0,14,258
2022,Zimbabwe,ZWE,United States of America,USA,0,0,0,97,11,0,108,0,5,0,68,0,5,78,2155
2022,Afghanistan,AFG,Uzbekistan,UZB,0,0,0,6,0,0,6,0,0,0,0,0,0,0,13026
2022,Afghanistan,AFG,Venezuela (Bolivarian Republic of),VEN,0,5,0,0,0,0,5,0,0,0,5,0,0,5,10
2022,Chile,CHL,Venezuela (Bolivarian Republic of),VEN,0,0,5,0,0,0,5,0,0,0,5,0,0,5,10
2022,Congo,COG,Venezuela (Bolivarian Republic of),VEN,0,0,0,0,0,0,0,0,0,0,5,0,0,5,5
2022,Colombia,COL,Venezuela (Bolivarian Republic of),VEN,800,1069,1336,2505,267,9600,15577,512,683,854,2029,171,10400,14649,30226
2022,Palestinian,PSE,Venezuela (Bolivarian Republic of),VEN,0,0,0,0,0,0,0,0,0,0,7,0,0,7,7
2022,Haiti,HTI,Venezuela (Bolivarian Republic of),VEN,0,0,0,5,0,0,5,0,0,0,7,0,0,7,12
2022,Iraq,IRQ,Venezuela (Bolivarian Republic of),VEN,0,0,0,8,0,0,8,0,0,0,10,0,0,10,18
2022,Liberia,LBR,Venezuela (Bolivarian Republic of),VEN,0,0,0,0,0,0,0,0,0,0,9,0,0,9,9
2022,Libya,LBY,Venezuela (Bolivarian Republic of),VEN,0,0,0,0,0,0,0,0,0,0,5,0,0,5,5
2022,Lebanon,LBN,Venezuela (Bolivarian Republic of),VEN,0,0,0,6,0,0,6,0,0,0,6,0,0,6,12
2022,Nigeria,NGA,Venezuela (Bolivarian Republic of),VEN,0,0,0,0,0,0,0,0,0,0,7,0,0,7,7
2022,Peru,PER,Venezuela (Bolivarian Republic of),VEN,0,0,0,5,0,0,5,0,0,0,0,0,0,0,5
2022,Rwanda,RWA,Venezuela (Bolivarian Republic of),VEN,0,0,0,5,0,0,5,0,0,0,0,0,0,0,5
2022,Sierra Leone,SLE,Venezuela (Bolivarian Republic of),VEN,0,0,0,0,0,0,0,0,0,0,5,0,0,5,5
2022,Syrian Arab Rep.,SYR,Venezuela (Bolivarian Republic of),VEN,0,0,0,17,0,0,17,0,0,0,16,0,0,16,33
2022,Türkiye,TUR,Venezuela (Bolivarian Republic of),VEN,0,0,0,0,0,0,0,0,0,0,6,0,0,6,6
2022,Western Sahara,ESH,Venezuela (Bolivarian Republic of),VEN,0,0,0,5,0,0,5,0,0,0,6,0,0,6,11
2022,Egypt,EGY,Yemen,YEM,0,0,0,17,0,0,17,0,0,0,8,0,0,8,25
2022,Dem. Rep. of the Congo,COD,Yemen,YEM,0,0,0,0,0,0,0,0,0,0,6,0,0,6,6
2022,Djibouti,DJI,Yemen,YEM,0,6,0,0,0,0,6,0,5,0,0,0,0,5,11
2022,Eritrea,ERI,Yemen,YEM,18,59,64,455,92,0,688,10,48,79,895,86,0,1118,1806
2022,Ethiopia,ETH,Yemen,YEM,463,926,800,4634,145,0,6968,519,1042,925,8315,154,0,10955,17923
2022,Palestinian,PSE,Yemen,YEM,0,21,64,290,45,0,420,10,28,47,311,72,0,468,888
2022,India,IND,Yemen,YEM,0,0,0,5,0,0,5,0,0,0,0,0,0,0,5
2022,Iran (Islamic Rep. of),IRN,Yemen,YEM,0,0,0,0,0,0,0,0,0,5,0,0,0,5,5
2022,Iraq,IRQ,Yemen,YEM,0,10,161,1039,228,0,1438,0,16,160,1231,364,0,1771,3209
2022,Jordan,JOR,Yemen,YEM,0,0,0,18,0,0,18,0,0,8,0,0,0,8,26
2022,Lebanon,LBN,Yemen,YEM,0,0,0,0,5,0,5,0,0,0,0,0,0,0,5
2022,Pakistan,PAK,Yemen,YEM,0,0,9,0,0,0,9,0,0,0,0,0,0,0,9
2022,Somalia,SOM,Yemen,YEM,1314,2863,3719,21672,1833,0,31401,1344,2915,3726,22480,1328,0,31793,63194
2022,Viet Nam,VNM,Yemen,YEM,0,0,0,6,0,0,6,0,0,0,9,0,0,9,15
2022,Sudan,SDN,Yemen,YEM,0,18,27,217,38,0,300,0,22,31,136,128,0,317,617
2022,Syrian Arab Rep.,SYR,Yemen,YEM,21,172,242,859,72,0,1366,31,200,250,963,129,0,1573,2939
2022,Afghanistan,AFG,Zambia,ZMB,0,0,6,0,0,0,6,0,0,0,0,0,0,0,6
2022,Burundi,BDI,Zambia,ZMB,373,410,291,1203,30,0,2307,386,395,349,4303,33,0,5466,7773
2022,Cameroon,CMR,Zambia,ZMB,0,0,0,5,0,0,5,0,0,0,20,0,0,20,25
2022,Congo,COG,Zambia,ZMB,0,0,0,0,0,0,0,0,0,0,5,0,0,5,5
2022,Dem. Rep. of the Congo,COD,Zambia,ZMB,3637,5425,4149,11081,454,0,24746,3746,5312,4167,13565,526,0,27316,52062
2022,Eritrea,ERI,Zambia,ZMB,0,8,0,18,0,0,26,0,7,0,90,0,0,97,123
2022,Ethiopia,ETH,Zambia,ZMB,0,5,0,10,0,0,15,0,0,6,32,0,0,38,53
2022,Palestinian,PSE,Zambia,ZMB,0,0,0,5,0,0,5,0,0,0,6,0,0,6,11
2022,India,IND,Zambia,ZMB,0,0,0,0,0,0,0,0,0,5,0,0,0,5,5
2022,Kenya,KEN,Zambia,ZMB,0,0,0,0,0,0,0,5,0,0,0,0,0,5,5
2022,Liberia,LBR,Zambia,ZMB,0,0,0,0,0,0,0,0,0,0,0,6,0,6,6
2022,South Africa,ZAF,Zambia,ZMB,0,0,0,6,0,0,6,0,0,0,0,0,0,0,6
2022,Russian Federation,RUS,Zambia,ZMB,0,5,0,0,0,0,5,0,0,0,0,0,0,0,5
2022,Rwanda,RWA,Zambia,ZMB,33,53,82,179,24,0,371,30,65,56,194,20,0,365,736
2022,Sierra Leone,SLE,Zambia,ZMB,0,0,0,0,0,0,0,0,0,0,0,5,0,5,5
2022,Somalia,SOM,Zambia,ZMB,104,132,122,561,10,0,929,91,155,98,1444,44,0,1832,2761
2022,South Sudan,SSD,Zambia,ZMB,0,0,0,0,0,0,0,0,5,0,0,0,0,5,5
2022,Sudan,SDN,Zambia,ZMB,0,0,7,0,0,0,7,9,0,0,12,0,0,21,28
2022,Syrian Arab Rep.,SYR,Zambia,ZMB,5,0,0,5,0,0,10,0,5,0,17,0,0,22,32
2022,Türkiye,TUR,Zambia,ZMB,0,0,0,8,0,0,8,0,0,5,8,0,0,13,21
2022,Uganda,UGA,Zambia,ZMB,11,14,5,44,0,0,74,8,6,8,151,8,0,181,255
2022,Zimbabwe,ZWE,Zambia,ZMB,0,0,0,0,0,0,0,0,0,0,5,0,0,5,5
2022,Angola,AGO,Zimbabwe,ZWE,0,6,0,0,0,0,6,0,0,0,0,0,0,0,6
2022,Burundi,BDI,Zimbabwe,ZWE,44,75,53,223,5,0,400,46,70,65,330,5,0,516,916
2022,Central African Rep.,CAF,Zimbabwe,ZWE,5,0,0,0,0,0,5,0,0,0,0,0,0,0,5
2022,Cameroon,CMR,Zimbabwe,ZWE,0,0,0,0,0,0,0,0,0,0,11,0,0,11,11
2022,Congo,COG,Zimbabwe,ZWE,0,0,0,6,0,0,6,0,5,9,0,0,0,14,20
2022,Dem. Rep. of the Congo,COD,Zimbabwe,ZWE,761,1156,832,2548,76,0,5373,775,1167,943,3459,58,0,6402,11775
2022,Eritrea,ERI,Zimbabwe,ZWE,0,0,8,5,0,0,13,0,0,0,13,0,0,13,26
2022,Ethiopia,ETH,Zimbabwe,ZWE,0,9,8,17,0,0,34,5,0,5,48,0,0,58,92
2022,Cote d'Ivoire,CIV,Zimbabwe,ZWE,9,5,0,0,0,0,14,0,0,0,25,0,0,25,39
2022,Kenya,KEN,Zimbabwe,ZWE,0,0,0,0,0,0,0,0,0,8,0,0,0,8,8
2022,Mali,MLI,Zimbabwe,ZWE,5,10,0,21,0,0,36,6,11,0,73,0,0,90,126
2022,Mozambique,MOZ,Zimbabwe,ZWE,130,256,163,345,51,0,945,147,232,162,238,29,0,808,8299
2022,Rwanda,RWA,Zimbabwe,ZWE,32,56,50,201,15,0,354,26,57,53,211,25,0,372,726
2022,Sierra Leone,SLE,Zimbabwe,ZWE,0,0,0,0,0,0,0,0,0,0,7,0,0,7,7
2022,Somalia,SOM,Zimbabwe,ZWE,0,0,0,11,0,0,11,0,13,0,17,0,0,30,41
2022,South Sudan,SSD,Zimbabwe,ZWE,0,8,0,7,0,0,15,0,0,5,13,0,0,18,33
2022,Sudan,SDN,Zimbabwe,ZWE,0,6,0,0,0,0,6,0,0,0,0,0,0,0,6
2022,Uganda,UGA,Zimbabwe,ZWE,0,0,0,0,0,0,0,0,0,9,0,0,0,9,9